round,region,winner_seed,winner_team,winner_score,loser_seed,loser,loser_score,score_diff,year
Round of 64,East,1,Georgetown,68,16,Lehigh,43,25,1985
Round of 64,East,4,"Loyola, Illinois",59,13,Iona,58,1,1985
Round of 64,East,5,Southern Methodist,85,12,Old Dominion,68,17,1985
Round of 64,East,8,Temple,60,9,Virginia Tech,57,3,1985
Round of 64,Midwest,1,Oklahoma,96,16,North Carolina A&T,83,13,1985
Round of 64,Midwest,4,Ohio State,75,13,Iowa State,64,11,1985
Round of 64,Midwest,5,Louisiana Tech,78,12,Pittsburgh,54,24,1985
Round of 64,Midwest,9,Illinois State,58,8,Southern California,55,3,1985
Round of 64,Southeast,2,North Carolina,76,15,Middle Tennessee State,57,19,1985
Round of 64,Southeast,3,Kansas,49,14,Ohio,38,11,1985
Round of 64,Southeast,7,Notre Dame,79,10,Oregon State,70,9,1985
Round of 64,Southeast,11,Auburn,59,6,Purdue,58,1,1985
Round of 64,West,1,"St. John's, New York",83,16,Southern,59,24,1985
Round of 64,West,4,Nevada-Las Vegas,85,13,San Diego State,80,5,1985
Round of 64,West,9,Arkansas,63,8,Iowa,54,9,1985
Round of 64,West,12,Kentucky,66,5,Washington,58,8,1985
Round of 64,East,2,Georgia Tech,65,15,Mercer,58,7,1985
Round of 64,East,3,Illinois,76,14,Northeastern,57,19,1985
Round of 64,East,6,Georgia,67,11,Wichita State,59,8,1985
Round of 64,East,7,Syracuse,70,10,DePaul,65,5,1985
Round of 64,Midwest,2,Memphis,67,15,Pennsylvania,55,12,1985
Round of 64,Midwest,3,Duke,75,14,Pepperdine,62,13,1985
Round of 64,Midwest,7,UAB,70,10,Michigan State,68,2,1985
Round of 64,Midwest,11,Boston College,55,6,Texas Tech,53,2,1985
Round of 64,Southeast,1,Michigan,59,16,Fairleigh Dickinson,55,4,1985
Round of 64,Southeast,5,Maryland,69,12,"Miami, Ohio",68,1,1985
Round of 64,Southeast,8,Villanova,51,9,Dayton,49,2,1985
Round of 64,Southeast,13,Navy,78,4,Louisiana State,55,23,1985
Round of 64,West,2,Virginia Commonwealth,81,15,Marshall,65,16,1985
Round of 64,West,3,North Carolina State,65,14,Nevada,56,9,1985
Round of 64,West,7,Alabama,50,10,Arizona,41,9,1985
Round of 64,West,11,Texas-El Paso,79,6,Tulsa,75,4,1985
Round of 32,East,1,Georgetown,63,8,Temple,46,17,1985
Round of 32,East,4,"Loyola, Illinois",70,5,Southern Methodist,57,13,1985
Round of 32,Midwest,1,Oklahoma,75,9,Illinois State,69,6,1985
Round of 32,Midwest,5,Louisiana Tech,79,4,Ohio State,67,12,1985
Round of 32,Southeast,2,North Carolina,60,7,Notre Dame,58,2,1985
Round of 32,Southeast,11,Auburn,66,3,Kansas,64,2,1985
Round of 32,West,1,"St. John's, New York",68,9,Arkansas,65,3,1985
Round of 32,West,12,Kentucky,64,4,Nevada-Las Vegas,61,3,1985
Round of 32,East,2,Georgia Tech,70,7,Syracuse,53,17,1985
Round of 32,East,3,Illinois,74,6,Georgia,58,16,1985
Round of 32,Midwest,2,Memphis,67,7,UAB,66,1,1985
Round of 32,Midwest,11,Boston College,74,3,Duke,73,1,1985
Round of 32,Southeast,5,Maryland,64,13,Navy,59,5,1985
Round of 32,Southeast,8,Villanova,59,1,Michigan,55,4,1985
Round of 32,West,3,North Carolina State,86,11,Texas-El Paso,73,13,1985
Round of 32,West,7,Alabama,63,2,Virginia Commonwealth,59,4,1985
Sweet Sixteen,East,1,Georgetown,65,4,"Loyola, Illinois",53,12,1985
Sweet Sixteen,East,2,Georgia Tech,61,3,Illinois,53,8,1985
Sweet Sixteen,Midwest,1,Oklahoma,86,5,Louisiana Tech,84,2,1985
Sweet Sixteen,Midwest,2,Memphis,59,11,Boston College,57,2,1985
Sweet Sixteen,Southeast,2,North Carolina,62,11,Auburn,56,6,1985
Sweet Sixteen,Southeast,8,Villanova,46,5,Maryland,43,3,1985
Sweet Sixteen,West,1,"St. John's, New York",86,12,Kentucky,70,16,1985
Sweet Sixteen,West,3,North Carolina State,61,7,Alabama,55,6,1985
Elite Eight,East,1,Georgetown,60,2,Georgia Tech,54,6,1985
Elite Eight,Midwest,2,Memphis,63,1,Oklahoma,61,2,1985
Elite Eight,Southeast,8,Villanova,56,2,North Carolina,44,12,1985
Elite Eight,West,1,"St. John's, New York",69,3,North Carolina State,60,9,1985
National Semifinals,National Semifinals,1,Georgetown,77,1,"St. John's, New York",59,18,1985
National Semifinals,National Semifinals,8,Villanova,52,2,Memphis,45,7,1985
National Championship,National Championship,8,Villanova,66,1,Georgetown,64,2,1985
Round of 64,East,1,Duke,85,16,Mississippi Valley,78,7,1986
Round of 64,East,4,Oklahoma,80,13,Northeastern,74,6,1986
Round of 64,East,8,Old Dominion,72,9,West Virginia,64,8,1986
Round of 64,East,12,DePaul,72,5,Virginia,68,4,1986
Round of 64,Midwest,1,Kansas,71,16,North Carolina A&T,46,25,1986
Round of 64,Midwest,4,Georgetown,70,13,Texas Tech,64,6,1986
Round of 64,Midwest,5,Michigan State,72,12,Washington,70,2,1986
Round of 64,Midwest,9,Temple,61,8,Jacksonville,50,11,1986
Round of 64,Southeast,2,Georgia Tech,68,15,Marist,53,15,1986
Round of 64,Southeast,3,Memphis,95,14,Ball State,63,32,1986
Round of 64,Southeast,10,Villanova,71,7,Virginia Tech,62,9,1986
Round of 64,Southeast,11,Louisiana State,94,6,Purdue,87,7,1986
Round of 64,West,2,Louisville,93,15,Drexel,73,20,1986
Round of 64,West,3,North Carolina,84,14,Utah,72,12,1986
Round of 64,West,6,UAB,66,11,Missouri,64,2,1986
Round of 64,West,7,Bradley,83,10,Texas-El Paso,65,18,1986
Round of 64,East,2,Syracuse,101,15,Brown,52,49,1986
Round of 64,East,6,"St. Joseph's, Pennsylvania",60,11,Richmond,59,1,1986
Round of 64,East,7,Navy,87,10,Tulsa,68,19,1986
Round of 64,East,14,Cleveland State,83,3,Indiana,79,4,1986
Round of 64,Midwest,2,Michigan,70,15,Akron,64,6,1986
Round of 64,Midwest,6,North Carolina State,66,11,Iowa,64,2,1986
Round of 64,Midwest,7,Iowa State,81,10,"Miami, Ohio",79,2,1986
Round of 64,Midwest,14,Arkansas-Little Rock,90,3,Notre Dame,83,7,1986
Round of 64,Southeast,1,Kentucky,75,16,Davidson,55,20,1986
Round of 64,Southeast,4,Illinois,75,13,Fairfield,51,24,1986
Round of 64,Southeast,5,Alabama,97,12,"Xavier, Ohio",80,17,1986
Round of 64,Southeast,8,Western Kentucky,67,9,Nebraska,59,8,1986
Round of 64,West,1,"St. John's, New York",83,16,Montana State,74,9,1986
Round of 64,West,4,Nevada-Las Vegas,74,13,Louisiana-Monroe,51,23,1986
Round of 64,West,5,Maryland,69,12,Pepperdine,64,5,1986
Round of 64,West,8,Auburn,73,9,Arizona,63,10,1986
Round of 32,East,1,Duke,89,8,Old Dominion,61,28,1986
Round of 32,East,12,DePaul,74,4,Oklahoma,69,5,1986
Round of 32,Midwest,1,Kansas,65,9,Temple,43,22,1986
Round of 32,Midwest,5,Michigan State,80,4,Georgetown,68,12,1986
Round of 32,Southeast,2,Georgia Tech,66,10,Villanova,61,5,1986
Round of 32,Southeast,11,Louisiana State,83,3,Memphis,81,2,1986
Round of 32,West,2,Louisville,82,7,Bradley,68,14,1986
Round of 32,West,3,North Carolina,77,6,UAB,59,18,1986
Round of 32,East,7,Navy,97,2,Syracuse,85,12,1986
Round of 32,East,14,Cleveland State,75,6,"St. Joseph's, Pennsylvania",69,6,1986
Round of 32,Midwest,6,North Carolina State,80,14,Arkansas-Little Rock,66,14,1986
Round of 32,Midwest,7,Iowa State,72,2,Michigan,69,3,1986
Round of 32,Southeast,1,Kentucky,71,8,Western Kentucky,64,7,1986
Round of 32,Southeast,5,Alabama,58,4,Illinois,56,2,1986
Round of 32,West,4,Nevada-Las Vegas,70,5,Maryland,64,6,1986
Round of 32,West,8,Auburn,81,1,"St. John's, New York",65,16,1986
Sweet Sixteen,Southeast,1,Kentucky,68,5,Alabama,63,5,1986
Sweet Sixteen,Southeast,11,Louisiana State,70,2,Georgia Tech,64,6,1986
Sweet Sixteen,West,2,Louisville,94,3,North Carolina,79,15,1986
Sweet Sixteen,West,8,Auburn,70,4,Nevada-Las Vegas,63,7,1986
Sweet Sixteen,East,1,Duke,74,12,DePaul,67,7,1986
Sweet Sixteen,East,7,Navy,71,14,Cleveland State,70,1,1986
Sweet Sixteen,Midwest,1,Kansas,96,5,Michigan State,86,10,1986
Sweet Sixteen,Midwest,6,North Carolina State,70,7,Iowa State,66,4,1986
Elite Eight,Southeast,11,Louisiana State,59,1,Kentucky,57,2,1986
Elite Eight,West,2,Louisville,84,8,Auburn,76,8,1986
Elite Eight,East,1,Duke,71,7,Navy,50,21,1986
Elite Eight,Midwest,1,Kansas,75,6,North Carolina State,67,8,1986
National Semifinals,National Semifinals,1,Duke,71,1,Kansas,67,4,1986
National Semifinals,National Semifinals,2,Louisville,88,11,Louisiana State,77,11,1986
National Championship,National Championship,2,Louisville,72,1,Duke,69,3,1986
Round of 64,East,1,North Carolina,113,16,Pennsylvania,82,31,1987
Round of 64,East,4,Texas Christian,76,13,Marshall,60,16,1987
Round of 64,East,5,Notre Dame,84,12,Middle Tennessee State,71,13,1987
Round of 64,East,9,Michigan,97,8,Navy,82,15,1987
Round of 64,Midwest,1,Indiana,92,16,Fairfield,58,34,1987
Round of 64,Midwest,5,Duke,58,12,Texas A&M,51,7,1987
Round of 64,Midwest,8,Auburn,62,9,San Diego,61,1,1987
Round of 64,Midwest,13,"Xavier, Ohio",70,4,Missouri,69,1,1987
Round of 64,Southeast,2,Alabama,88,15,North Carolina A&T,71,17,1987
Round of 64,Southeast,6,Providence,90,11,UAB,68,22,1987
Round of 64,Southeast,7,New Orleans,83,10,Brigham Young,79,4,1987
Round of 64,Southeast,14,Austin Peay,68,3,Illinois,67,1,1987
Round of 64,West,1,Nevada-Las Vegas,95,16,Idaho State,70,25,1987
Round of 64,West,4,UCLA,92,13,Central Michigan,73,19,1987
Round of 64,West,9,Kansas State,82,8,Georgia,79,3,1987
Round of 64,West,12,Wyoming,64,5,Virginia,60,4,1987
Round of 64,East,2,Syracuse,79,15,Georgia Southern,73,6,1987
Round of 64,East,3,Purdue,104,14,Northeastern,95,9,1987
Round of 64,East,6,Florida,82,11,North Carolina State,70,12,1987
Round of 64,East,10,Western Kentucky,64,7,West Virginia,62,2,1987
Round of 64,Midwest,2,Temple,75,15,Southern,56,19,1987
Round of 64,Midwest,3,DePaul,76,14,Louisiana Tech,62,14,1987
Round of 64,Midwest,6,"St. John's, New York",57,11,Wichita State,55,2,1987
Round of 64,Midwest,10,Louisiana State,85,7,Georgia Tech,79,6,1987
Round of 64,Southeast,1,Georgetown,75,16,Bucknell,53,22,1987
Round of 64,Southeast,5,Kansas,66,12,Houston,55,11,1987
Round of 64,Southeast,9,Ohio State,91,8,Kentucky,77,14,1987
Round of 64,Southeast,13,Missouri State,65,4,Clemson,60,5,1987
Round of 64,West,2,Iowa,99,15,Santa Clara,76,23,1987
Round of 64,West,3,Pittsburgh,93,14,Marist,68,25,1987
Round of 64,West,6,Oklahoma,74,11,Tulsa,69,5,1987
Round of 64,West,7,Texas-El Paso,98,10,Arizona,91,7,1987
Round of 32,East,1,North Carolina,109,9,Michigan,97,12,1987
Round of 32,East,5,Notre Dame,58,4,Texas Christian,57,1,1987
Round of 32,Midwest,1,Indiana,107,8,Auburn,90,17,1987
Round of 32,Midwest,5,Duke,65,13,"Xavier, Ohio",60,5,1987
Round of 32,Southeast,2,Alabama,101,7,New Orleans,76,25,1987
Round of 32,Southeast,6,Providence,90,14,Austin Peay,87,3,1987
Round of 32,West,1,Nevada-Las Vegas,80,9,Kansas State,61,19,1987
Round of 32,West,12,Wyoming,78,4,UCLA,68,10,1987
Round of 32,East,2,Syracuse,104,10,Western Kentucky,86,18,1987
Round of 32,East,6,Florida,85,3,Purdue,66,19,1987
Round of 32,Midwest,3,DePaul,83,6,"St. John's, New York",75,8,1987
Round of 32,Midwest,10,Louisiana State,72,2,Temple,62,10,1987
Round of 32,Southeast,1,Georgetown,82,9,Ohio State,79,3,1987
Round of 32,Southeast,5,Kansas,67,13,Missouri State,63,4,1987
Round of 32,West,2,Iowa,84,7,Texas-El Paso,82,2,1987
Round of 32,West,6,Oklahoma,96,3,Pittsburgh,93,3,1987
Sweet Sixteen,East,1,North Carolina,74,5,Notre Dame,68,6,1987
Sweet Sixteen,East,2,Syracuse,87,6,Florida,81,6,1987
Sweet Sixteen,Southeast,1,Georgetown,70,5,Kansas,57,13,1987
Sweet Sixteen,Southeast,6,Providence,103,2,Alabama,82,21,1987
Sweet Sixteen,Midwest,1,Indiana,88,5,Duke,82,6,1987
Sweet Sixteen,Midwest,10,Louisiana State,63,3,DePaul,58,5,1987
Sweet Sixteen,West,1,Nevada-Las Vegas,92,12,Wyoming,78,14,1987
Sweet Sixteen,West,2,Iowa,93,6,Oklahoma,91,2,1987
Elite Eight,East,2,Syracuse,79,1,North Carolina,75,4,1987
Elite Eight,Southeast,6,Providence,88,1,Georgetown,73,15,1987
Elite Eight,Midwest,1,Indiana,77,10,Louisiana State,76,1,1987
Elite Eight,West,1,Nevada-Las Vegas,84,2,Iowa,81,3,1987
National Semifinals,National Semifinals,1,Indiana,97,1,Nevada-Las Vegas,93,4,1987
National Semifinals,National Semifinals,2,Syracuse,77,6,Providence,63,14,1987
National Championship,National Championship,1,Indiana,74,2,Syracuse,73,1,1987
Round of 64,East,2,Duke,85,15,Boston,69,16,1988
Round of 64,East,3,Syracuse,69,14,North Carolina A&T,55,14,1988
Round of 64,East,7,Southern Methodist,83,10,Notre Dame,75,8,1988
Round of 64,East,11,Rhode Island,87,6,Missouri,80,7,1988
Round of 64,Midwest,1,Purdue,94,16,Fairleigh Dickinson,79,15,1988
Round of 64,Midwest,4,Kansas State,66,13,La Salle,53,13,1988
Round of 64,Midwest,5,DePaul,83,12,Wichita State,62,21,1988
Round of 64,Midwest,9,Memphis,75,8,Baylor,60,15,1988
Round of 64,Southeast,1,Oklahoma,94,16,Chattanooga,66,28,1988
Round of 64,Southeast,4,Brigham Young,98,13,Charlotte,92,6,1988
Round of 64,Southeast,5,Louisville,70,12,Oregon State,61,9,1988
Round of 64,Southeast,8,Auburn,90,9,Bradley,86,4,1988
Round of 64,West,2,North Carolina,83,15,North Texas,65,18,1988
Round of 64,West,3,Michigan,63,14,Boise State,58,5,1988
Round of 64,West,6,Florida,62,11,"St. John's, New York",59,3,1988
Round of 64,West,10,Loyola Marymount,119,7,Wyoming,115,4,1988
Round of 64,East,1,Temple,87,16,Lehigh,73,14,1988
Round of 64,East,5,Georgia Tech,90,12,Iowa State,78,12,1988
Round of 64,East,8,Georgetown,66,9,Louisiana State,63,3,1988
Round of 64,East,13,Richmond,72,4,Indiana,69,3,1988
Round of 64,Midwest,2,Pittsburgh,108,15,Eastern Michigan,90,18,1988
Round of 64,Midwest,6,Kansas,85,11,"Xavier, Ohio",72,13,1988
Round of 64,Midwest,7,Vanderbilt,80,10,Utah State,77,3,1988
Round of 64,Midwest,14,Murray State,78,3,North Carolina State,75,3,1988
Round of 64,Southeast,2,Kentucky,99,15,Southern,84,15,1988
Round of 64,Southeast,3,Illinois,81,14,Texas-San Antonio,72,9,1988
Round of 64,Southeast,6,Villanova,82,11,Arkansas,74,8,1988
Round of 64,Southeast,7,Maryland,92,10,California-Santa Barbara,82,10,1988
Round of 64,West,1,Arizona,90,16,Cornell,50,40,1988
Round of 64,West,4,Nevada-Las Vegas,54,13,Missouri State,50,4,1988
Round of 64,West,5,Iowa,102,12,Florida State,98,4,1988
Round of 64,West,8,Seton Hall,80,9,Texas-El Paso,64,16,1988
Round of 32,East,2,Duke,94,7,Southern Methodist,79,15,1988
Round of 32,East,11,Rhode Island,97,3,Syracuse,94,3,1988
Round of 32,Midwest,1,Purdue,100,9,Memphis,73,27,1988
Round of 32,Midwest,4,Kansas State,66,5,DePaul,58,8,1988
Round of 32,Southeast,1,Oklahoma,107,8,Auburn,87,20,1988
Round of 32,Southeast,5,Louisville,97,4,Brigham Young,76,21,1988
Round of 32,West,2,North Carolina,123,10,Loyola Marymount,97,26,1988
Round of 32,West,3,Michigan,108,6,Florida,85,23,1988
Round of 32,East,1,Temple,74,8,Georgetown,53,21,1988
Round of 32,East,13,Richmond,59,5,Georgia Tech,55,4,1988
Round of 32,Midwest,6,Kansas,61,14,Murray State,58,3,1988
Round of 32,Midwest,7,Vanderbilt,80,2,Pittsburgh,74,6,1988
Round of 32,Southeast,2,Kentucky,90,7,Maryland,81,9,1988
Round of 32,Southeast,6,Villanova,66,3,Illinois,63,3,1988
Round of 32,West,1,Arizona,84,8,Seton Hall,55,29,1988
Round of 32,West,5,Iowa,104,4,Nevada-Las Vegas,86,18,1988
Sweet Sixteen,East,1,Temple,69,13,Richmond,47,22,1988
Sweet Sixteen,East,2,Duke,73,11,Rhode Island,72,1,1988
Sweet Sixteen,Southeast,1,Oklahoma,108,5,Louisville,98,10,1988
Sweet Sixteen,Southeast,6,Villanova,80,2,Kentucky,74,6,1988
Sweet Sixteen,Midwest,4,Kansas State,73,1,Purdue,70,3,1988
Sweet Sixteen,Midwest,6,Kansas,77,7,Vanderbilt,64,13,1988
Sweet Sixteen,West,1,Arizona,99,5,Iowa,79,20,1988
Sweet Sixteen,West,2,North Carolina,78,3,Michigan,69,9,1988
Elite Eight,East,2,Duke,63,1,Temple,53,10,1988
Elite Eight,Southeast,1,Oklahoma,78,6,Villanova,59,19,1988
Elite Eight,Midwest,6,Kansas,71,4,Kansas State,58,13,1988
Elite Eight,West,1,Arizona,70,2,North Carolina,52,18,1988
National Semifinals,National Semifinals,1,Oklahoma,86,1,Arizona,78,8,1988
National Semifinals,National Semifinals,6,Kansas,66,2,Duke,59,7,1988
National Championship,National Championship,6,Kansas,83,1,Oklahoma,79,4,1988
Round of 64,East,2,Duke,90,15,South Carolina State,69,21,1989
Round of 64,East,7,West Virginia,84,10,Tennessee,68,16,1989
Round of 64,East,11,Minnesota,86,6,Kansas State,75,11,1989
Round of 64,East,14,Siena,80,3,Stanford,78,2,1989
Round of 64,Midwest,1,Illinois,77,16,McNeese State,71,6,1989
Round of 64,Midwest,4,Louisville,76,13,Arkansas-Little Rock,71,5,1989
Round of 64,Midwest,5,Arkansas,120,12,Loyola Marymount,101,19,1989
Round of 64,Midwest,9,Ball State,68,8,Pittsburgh,64,4,1989
Round of 64,Southeast,1,Oklahoma,72,16,East Tennessee State,71,1,1989
Round of 64,Southeast,5,Virginia,100,12,Providence,97,3,1989
Round of 64,Southeast,9,Louisiana Tech,83,8,La Salle,74,9,1989
Round of 64,Southeast,13,Middle Tennessee State,97,4,Florida State,83,14,1989
Round of 64,West,1,Arizona,94,16,Robert Morris,60,34,1989
Round of 64,West,4,Nevada-Las Vegas,68,13,Idaho,56,12,1989
Round of 64,West,9,Clemson,83,8,"St. Mary's, California",70,13,1989
Round of 64,West,12,DePaul,66,5,Memphis,63,3,1989
Round of 64,East,1,Georgetown,50,16,Princeton,49,1,1989
Round of 64,East,4,Iowa,87,13,Rutgers,73,14,1989
Round of 64,East,5,North Carolina State,81,12,South Carolina,66,15,1989
Round of 64,East,9,Notre Dame,81,8,Vanderbilt,65,16,1989
Round of 64,Midwest,2,Syracuse,104,15,Bucknell,81,23,1989
Round of 64,Midwest,3,Missouri,85,14,Creighton,69,16,1989
Round of 64,Midwest,10,Colorado State,68,7,Florida,46,22,1989
Round of 64,Midwest,11,Texas,76,6,Georgia Tech,70,6,1989
Round of 64,Southeast,2,North Carolina,93,15,Southern,79,14,1989
Round of 64,Southeast,3,Michigan,92,14,"Xavier, Ohio",87,5,1989
Round of 64,Southeast,7,UCLA,84,10,Iowa State,74,10,1989
Round of 64,Southeast,11,South Alabama,86,6,Alabama,84,2,1989
Round of 64,West,2,Indiana,99,15,George Mason,85,14,1989
Round of 64,West,3,Seton Hall,60,14,Missouri State,51,9,1989
Round of 64,West,7,Texas-El Paso,85,10,Louisiana State,74,11,1989
Round of 64,West,11,Evansville,94,6,Oregon State,90,4,1989
Round of 32,East,2,Duke,70,7,West Virginia,63,7,1989
Round of 32,East,11,Minnesota,80,14,Siena,67,13,1989
Round of 32,Midwest,1,Illinois,72,9,Ball State,60,12,1989
Round of 32,Midwest,4,Louisville,93,5,Arkansas,84,9,1989
Round of 32,Southeast,1,Oklahoma,124,9,Louisiana Tech,81,43,1989
Round of 32,Southeast,5,Virginia,104,13,Middle Tennessee State,88,16,1989
Round of 32,West,1,Arizona,94,9,Clemson,68,26,1989
Round of 32,West,4,Nevada-Las Vegas,85,12,DePaul,70,15,1989
Round of 32,East,1,Georgetown,81,9,Notre Dame,74,7,1989
Round of 32,East,5,North Carolina State,102,4,Iowa,96,6,1989
Round of 32,Midwest,2,Syracuse,65,10,Colorado State,50,15,1989
Round of 32,Midwest,3,Missouri,108,11,Texas,89,19,1989
Round of 32,Southeast,2,North Carolina,88,7,UCLA,81,7,1989
Round of 32,Southeast,3,Michigan,91,11,South Alabama,82,9,1989
Round of 32,West,2,Indiana,92,7,Texas-El Paso,69,23,1989
Round of 32,West,3,Seton Hall,87,11,Evansville,73,14,1989
Sweet Sixteen,Southeast,3,Michigan,92,2,North Carolina,87,5,1989
Sweet Sixteen,Southeast,5,Virginia,86,1,Oklahoma,80,6,1989
Sweet Sixteen,West,3,Seton Hall,78,2,Indiana,65,13,1989
Sweet Sixteen,West,4,Nevada-Las Vegas,68,1,Arizona,67,1,1989
Sweet Sixteen,East,1,Georgetown,69,5,North Carolina State,61,8,1989
Sweet Sixteen,East,2,Duke,87,11,Minnesota,70,17,1989
Sweet Sixteen,Midwest,1,Illinois,83,4,Louisville,69,14,1989
Sweet Sixteen,Midwest,2,Syracuse,83,3,Missouri,80,3,1989
Elite Eight,Southeast,3,Michigan,102,5,Virginia,65,37,1989
Elite Eight,West,3,Seton Hall,84,4,Nevada-Las Vegas,61,23,1989
Elite Eight,East,2,Duke,85,1,Georgetown,77,8,1989
Elite Eight,Midwest,1,Illinois,89,2,Syracuse,86,3,1989
National Semifinals,National Semifinals,3,Michigan,83,1,Illinois,81,2,1989
National Semifinals,National Semifinals,3,Seton Hall,95,2,Duke,78,17,1989
National Championship,National Championship,3,Michigan,80,3,Seton Hall,79,1,1989
Round of 64,East,1,Connecticut,76,16,Boston,52,24,1990
Round of 64,East,4,La Salle,79,13,Southern Mississippi,63,16,1990
Round of 64,East,5,Clemson,49,12,Brigham Young,47,2,1990
Round of 64,East,9,California,65,8,Indiana,63,2,1990
Round of 64,Midwest,1,Oklahoma,77,16,Towson,68,9,1990
Round of 64,Midwest,4,Arkansas,68,13,Princeton,64,4,1990
Round of 64,Midwest,8,North Carolina,83,9,Missouri State,70,13,1990
Round of 64,Midwest,12,Dayton,88,5,Illinois,86,2,1990
Round of 64,Southeast,1,Michigan State,75,16,Murray State,71,4,1990
Round of 64,Southeast,4,Georgia Tech,99,13,East Tennessee State,83,16,1990
Round of 64,Southeast,5,Louisiana State,70,12,Villanova,63,7,1990
Round of 64,Southeast,9,California-Santa Barbara,70,8,Houston,66,4,1990
Round of 64,West,1,Nevada-Las Vegas,102,16,Arkansas-Little Rock,72,30,1990
Round of 64,West,4,Louisville,78,13,Idaho,59,19,1990
Round of 64,West,8,Ohio State,84,9,Providence,83,1,1990
Round of 64,West,12,Ball State,54,5,Oregon State,53,1,1990
Round of 64,East,2,Kansas,79,15,Robert Morris,71,8,1990
Round of 64,East,3,Duke,81,14,Richmond,46,35,1990
Round of 64,East,6,"St. John's, New York",81,11,Temple,65,16,1990
Round of 64,East,7,UCLA,68,10,UAB,56,12,1990
Round of 64,Midwest,2,Purdue,75,15,Louisiana-Monroe,63,12,1990
Round of 64,Midwest,3,Georgetown,70,14,Texas Southern,52,18,1990
Round of 64,Midwest,6,"Xavier, Ohio",87,11,Kansas State,79,8,1990
Round of 64,Midwest,10,Texas,100,7,Georgia,88,12,1990
Round of 64,Southeast,2,Syracuse,70,15,Coppin State,48,22,1990
Round of 64,Southeast,6,Minnesota,64,11,Texas-El Paso,61,3,1990
Round of 64,Southeast,7,Virginia,75,10,Notre Dame,67,8,1990
Round of 64,Southeast,14,Northern Iowa,74,3,Missouri,71,3,1990
Round of 64,West,2,Arizona,79,15,South Florida,67,12,1990
Round of 64,West,3,Michigan,76,14,Illinois State,70,6,1990
Round of 64,West,7,Alabama,71,10,Colorado State,54,17,1990
Round of 64,West,11,Loyola Marymount,111,6,New Mexico State,92,19,1990
Round of 32,East,1,Connecticut,74,9,California,54,20,1990
Round of 32,East,5,Clemson,79,4,La Salle,75,4,1990
Round of 32,Midwest,4,Arkansas,86,12,Dayton,84,2,1990
Round of 32,Midwest,8,North Carolina,79,1,Oklahoma,77,2,1990
Round of 32,Southeast,1,Michigan State,62,9,California-Santa Barbara,58,4,1990
Round of 32,Southeast,4,Georgia Tech,94,5,Louisiana State,91,3,1990
Round of 32,West,1,Nevada-Las Vegas,76,8,Ohio State,65,11,1990
Round of 32,West,12,Ball State,62,4,Louisville,60,2,1990
Round of 32,East,3,Duke,76,6,"St. John's, New York",72,4,1990
Round of 32,East,7,UCLA,71,2,Kansas,70,1,1990
Round of 32,Midwest,6,"Xavier, Ohio",74,3,Georgetown,71,3,1990
Round of 32,Midwest,10,Texas,73,2,Purdue,72,1,1990
Round of 32,Southeast,2,Syracuse,63,7,Virginia,61,2,1990
Round of 32,Southeast,6,Minnesota,81,14,Northern Iowa,78,3,1990
Round of 32,West,7,Alabama,77,2,Arizona,55,22,1990
Round of 32,West,11,Loyola Marymount,149,3,Michigan,115,34,1990
Sweet Sixteen,East,1,Connecticut,71,5,Clemson,70,1,1990
Sweet Sixteen,East,3,Duke,90,7,UCLA,81,9,1990
Sweet Sixteen,Midwest,4,Arkansas,96,8,North Carolina,73,23,1990
Sweet Sixteen,Midwest,10,Texas,102,6,"Xavier, Ohio",89,13,1990
Sweet Sixteen,Southeast,4,Georgia Tech,81,1,Michigan State,80,1,1990
Sweet Sixteen,Southeast,6,Minnesota,82,2,Syracuse,75,7,1990
Sweet Sixteen,West,1,Nevada-Las Vegas,69,12,Ball State,67,2,1990
Sweet Sixteen,West,11,Loyola Marymount,62,7,Alabama,60,2,1990
Elite Eight,East,3,Duke,79,1,Connecticut,78,1,1990
Elite Eight,Midwest,4,Arkansas,88,10,Texas,85,3,1990
Elite Eight,Southeast,4,Georgia Tech,93,6,Minnesota,91,2,1990
Elite Eight,West,1,Nevada-Las Vegas,131,11,Loyola Marymount,101,30,1990
National Semifinals,National Semifinals,1,Nevada-Las Vegas,90,4,Georgia Tech,81,9,1990
National Semifinals,National Semifinals,3,Duke,97,4,Arkansas,83,14,1990
National Championship,National Championship,1,Nevada-Las Vegas,103,3,Duke,73,30,1990
Round of 64,East,3,Oklahoma State,67,14,New Mexico,54,13,1991
Round of 64,East,6,North Carolina State,114,11,Southern Mississippi,85,29,1991
Round of 64,East,10,Temple,80,7,Purdue,63,17,1991
Round of 64,East,15,Richmond,73,2,Syracuse,69,4,1991
Round of 64,Midwest,2,Duke,102,15,Louisiana-Monroe,73,29,1991
Round of 64,Midwest,7,Iowa,76,10,East Tennessee State,73,3,1991
Round of 64,Midwest,11,Connecticut,79,6,Louisiana State,62,17,1991
Round of 64,Midwest,14,"Xavier, Ohio",89,3,Nebraska,84,5,1991
Round of 64,Southeast,2,Indiana,79,15,Coastal Carolina,69,10,1991
Round of 64,Southeast,3,Kansas,55,14,New Orleans,49,6,1991
Round of 64,Southeast,6,Pittsburgh,76,11,Georgia,68,8,1991
Round of 64,Southeast,7,Florida State,75,10,Southern California,72,3,1991
Round of 64,West,2,Arizona,93,15,"St. Francis, Pennsylvania",80,13,1991
Round of 64,West,3,Seton Hall,71,14,Pepperdine,51,20,1991
Round of 64,West,10,Brigham Young,61,7,Virginia,48,13,1991
Round of 64,West,11,Creighton,64,6,New Mexico State,56,8,1991
Round of 64,East,1,North Carolina,101,16,Northeastern,66,35,1991
Round of 64,East,9,Villanova,50,8,Princeton,48,2,1991
Round of 64,East,12,Eastern Michigan,76,5,Mississippi State,56,20,1991
Round of 64,East,13,Pennsylvania State,74,4,UCLA,69,5,1991
Round of 64,Midwest,1,Ohio State,97,16,Towson,86,11,1991
Round of 64,Midwest,4,"St. John's, New York",75,13,Northern Illinois,68,7,1991
Round of 64,Midwest,5,Texas,73,12,St. Peter's,65,8,1991
Round of 64,Midwest,8,Georgia Tech,87,9,DePaul,70,17,1991
Round of 64,Southeast,1,Arkansas,117,16,Georgia State,76,41,1991
Round of 64,Southeast,4,Alabama,89,13,Murray State,79,10,1991
Round of 64,Southeast,5,Wake Forest,71,12,Louisiana Tech,65,6,1991
Round of 64,Southeast,8,Arizona State,79,9,Rutgers,76,3,1991
Round of 64,West,1,Nevada-Las Vegas,99,16,Montana,65,34,1991
Round of 64,West,4,Utah,82,13,South Alabama,72,10,1991
Round of 64,West,5,Michigan State,60,12,Green Bay,58,2,1991
Round of 64,West,8,Georgetown,70,9,Vanderbilt,60,10,1991
Round of 32,East,3,Oklahoma State,73,6,North Carolina State,64,9,1991
Round of 32,East,10,Temple,77,15,Richmond,64,13,1991
Round of 32,Midwest,2,Duke,85,7,Iowa,70,15,1991
Round of 32,Midwest,11,Connecticut,66,14,"Xavier, Ohio",50,16,1991
Round of 32,Southeast,2,Indiana,82,7,Florida State,60,22,1991
Round of 32,Southeast,3,Kansas,77,6,Pittsburgh,66,11,1991
Round of 32,West,2,Arizona,76,10,Brigham Young,61,15,1991
Round of 32,West,3,Seton Hall,81,11,Creighton,69,12,1991
Round of 32,East,1,North Carolina,84,9,Villanova,69,15,1991
Round of 32,East,12,Eastern Michigan,71,13,Pennsylvania State,68,3,1991
Round of 32,Midwest,1,Ohio State,65,8,Georgia Tech,61,4,1991
Round of 32,Midwest,4,"St. John's, New York",84,5,Texas,76,8,1991
Round of 32,Southeast,1,Arkansas,97,8,Arizona State,90,7,1991
Round of 32,Southeast,4,Alabama,96,5,Wake Forest,88,8,1991
Round of 32,West,1,Nevada-Las Vegas,62,8,Georgetown,54,8,1991
Round of 32,West,4,Utah,85,5,Michigan State,84,1,1991
Sweet Sixteen,Southeast,1,Arkansas,93,4,Alabama,70,23,1991
Sweet Sixteen,Southeast,3,Kansas,83,2,Indiana,65,18,1991
Sweet Sixteen,West,1,Nevada-Las Vegas,83,4,Utah,66,17,1991
Sweet Sixteen,West,3,Seton Hall,81,2,Arizona,77,4,1991
Sweet Sixteen,East,1,North Carolina,93,12,Eastern Michigan,67,26,1991
Sweet Sixteen,East,10,Temple,72,3,Oklahoma State,63,9,1991
Sweet Sixteen,Midwest,2,Duke,81,11,Connecticut,67,14,1991
Sweet Sixteen,Midwest,4,"St. John's, New York",91,1,Ohio State,74,17,1991
Elite Eight,Southeast,3,Kansas,93,1,Arkansas,81,12,1991
Elite Eight,West,1,Nevada-Las Vegas,77,3,Seton Hall,65,12,1991
Elite Eight,East,1,North Carolina,75,10,Temple,72,3,1991
Elite Eight,Midwest,2,Duke,78,4,"St. John's, New York",61,17,1991
National Semifinals,National Semifinals,2,Duke,79,1,Nevada-Las Vegas,77,2,1991
National Semifinals,National Semifinals,3,Kansas,79,1,North Carolina,73,6,1991
National Championship,National Championship,2,Duke,72,3,Kansas,65,7,1991
Round of 64,East,1,Duke,82,16,Campbell,56,26,1992
Round of 64,East,4,Seton Hall,78,13,La Salle,76,2,1992
Round of 64,East,5,Missouri,89,12,West Virginia,78,11,1992
Round of 64,East,9,Iowa,98,8,Texas,92,6,1992
Round of 64,Midwest,2,Southern California,84,15,Louisiana-Monroe,54,30,1992
Round of 64,Midwest,3,Arkansas,80,14,Murray State,69,11,1992
Round of 64,Midwest,6,Memphis,80,11,Pepperdine,70,10,1992
Round of 64,Midwest,7,Georgia Tech,65,10,Houston,60,5,1992
Round of 64,Southeast,1,Ohio State,83,16,Mississippi Valley,56,27,1992
Round of 64,Southeast,4,North Carolina,68,13,"Miami, Ohio",63,5,1992
Round of 64,Southeast,5,Alabama,80,12,Stanford,75,5,1992
Round of 64,Southeast,9,Connecticut,86,8,Nebraska,65,21,1992
Round of 64,West,2,Indiana,94,15,Eastern Illinois,55,39,1992
Round of 64,West,3,Florida State,78,14,Montana,68,10,1992
Round of 64,West,6,Georgetown,75,11,South Florida,60,15,1992
Round of 64,West,7,Louisiana State,94,10,Brigham Young,83,11,1992
Round of 64,East,2,Kentucky,88,15,Old Dominion,69,19,1992
Round of 64,East,3,Massachusetts,85,14,Fordham,58,27,1992
Round of 64,East,6,Syracuse,51,11,Princeton,43,8,1992
Round of 64,East,10,Iowa State,76,7,Charlotte,74,2,1992
Round of 64,Midwest,1,Kansas,100,16,Howard,67,33,1992
Round of 64,Midwest,4,Cincinnati,85,13,Delaware,47,38,1992
Round of 64,Midwest,5,Michigan State,61,12,Missouri State,54,7,1992
Round of 64,Midwest,9,Texas-El Paso,55,8,Evansville,50,5,1992
Round of 64,Southeast,2,Oklahoma State,100,15,Georgia Southern,73,27,1992
Round of 64,Southeast,6,Michigan,73,11,Temple,66,7,1992
Round of 64,Southeast,10,Tulane,61,7,"St. John's, New York",57,4,1992
Round of 64,Southeast,14,East Tennessee State,87,3,Arizona,80,7,1992
Round of 64,West,1,UCLA,73,16,Robert Morris,53,20,1992
Round of 64,West,8,Louisville,81,9,Wake Forest,58,23,1992
Round of 64,West,12,New Mexico State,81,5,DePaul,73,8,1992
Round of 64,West,13,Louisiana-Lafayette,87,4,Oklahoma,83,4,1992
Round of 32,East,1,Duke,75,9,Iowa,62,13,1992
Round of 32,East,4,Seton Hall,88,5,Missouri,71,17,1992
Round of 32,Midwest,6,Memphis,82,3,Arkansas,80,2,1992
Round of 32,Midwest,7,Georgia Tech,79,2,Southern California,78,1,1992
Round of 32,Southeast,1,Ohio State,78,9,Connecticut,55,23,1992
Round of 32,Southeast,4,North Carolina,64,5,Alabama,55,9,1992
Round of 32,West,2,Indiana,89,7,Louisiana State,79,10,1992
Round of 32,West,3,Florida State,78,6,Georgetown,68,10,1992
Round of 32,East,2,Kentucky,106,10,Iowa State,98,8,1992
Round of 32,East,3,Massachusetts,77,6,Syracuse,71,6,1992
Round of 32,Midwest,4,Cincinnati,77,5,Michigan State,65,12,1992
Round of 32,Midwest,9,Texas-El Paso,66,1,Kansas,60,6,1992
Round of 32,Southeast,2,Oklahoma State,87,10,Tulane,71,16,1992
Round of 32,Southeast,6,Michigan,102,14,East Tennessee State,90,12,1992
Round of 32,West,1,UCLA,85,8,Louisville,69,16,1992
Round of 32,West,12,New Mexico State,81,13,Louisiana-Lafayette,73,8,1992
Sweet Sixteen,East,1,Duke,81,4,Seton Hall,69,12,1992
Sweet Sixteen,East,2,Kentucky,87,3,Massachusetts,77,10,1992
Sweet Sixteen,West,1,UCLA,85,12,New Mexico State,78,7,1992
Sweet Sixteen,West,2,Indiana,85,3,Florida State,74,11,1992
Sweet Sixteen,Midwest,4,Cincinnati,69,9,Texas-El Paso,67,2,1992
Sweet Sixteen,Midwest,6,Memphis,83,7,Georgia Tech,79,4,1992
Sweet Sixteen,Southeast,1,Ohio State,80,4,North Carolina,73,7,1992
Sweet Sixteen,Southeast,6,Michigan,75,2,Oklahoma State,72,3,1992
Elite Eight,East,1,Duke,104,2,Kentucky,103,1,1992
Elite Eight,West,2,Indiana,106,1,UCLA,79,27,1992
Elite Eight,Midwest,4,Cincinnati,88,6,Memphis,57,31,1992
Elite Eight,Southeast,6,Michigan,75,1,Ohio State,71,4,1992
National Semifinals,National Semifinals,1,Duke,81,2,Indiana,78,3,1992
National Semifinals,National Semifinals,6,Michigan,76,4,Cincinnati,72,4,1992
National Championship,National Championship,1,Duke,71,6,Michigan,51,20,1992
Round of 64,East,1,North Carolina,85,16,East Carolina,65,20,1993
Round of 64,East,4,Arkansas,94,13,Holy Cross,64,30,1993
Round of 64,East,5,"St. John's, New York",85,12,Texas Tech,67,18,1993
Round of 64,East,8,Rhode Island,74,9,Purdue,68,6,1993
Round of 64,Midwest,2,Kansas,94,15,Ball State,72,22,1993
Round of 64,Midwest,3,Duke,105,14,Southern Illinois,70,35,1993
Round of 64,Midwest,6,California,66,11,Louisiana State,64,2,1993
Round of 64,Midwest,7,Brigham Young,80,10,Southern Methodist,71,9,1993
Round of 64,Southeast,2,Seton Hall,81,15,Tennessee State,59,22,1993
Round of 64,Southeast,3,Florida State,82,14,Evansville,70,12,1993
Round of 64,Southeast,7,Western Kentucky,55,10,Memphis,52,3,1993
Round of 64,Southeast,11,Tulane,55,6,Kansas State,53,2,1993
Round of 64,West,3,Vanderbilt,92,14,Boise State,72,20,1993
Round of 64,West,6,Illinois,75,11,Long Beach State,72,3,1993
Round of 64,West,7,Temple,75,10,Missouri,61,14,1993
Round of 64,West,15,Santa Clara,64,2,Arizona,61,3,1993
Round of 64,East,2,Cincinnati,93,15,Coppin State,66,27,1993
Round of 64,East,3,Massachusetts,54,14,Pennsylvania,50,4,1993
Round of 64,East,6,Virginia,78,11,Manhattan,66,12,1993
Round of 64,East,7,New Mexico State,93,10,Nebraska,79,14,1993
Round of 64,Midwest,1,Indiana,97,16,Wright State,54,43,1993
Round of 64,Midwest,4,Louisville,76,13,Delaware,70,6,1993
Round of 64,Midwest,5,Oklahoma State,74,12,Marquette,62,12,1993
Round of 64,Midwest,9,"Xavier, Ohio",73,8,New Orleans,55,18,1993
Round of 64,Southeast,1,Kentucky,96,16,Rider,52,44,1993
Round of 64,Southeast,4,Iowa,82,13,Louisiana-Monroe,69,13,1993
Round of 64,Southeast,5,Wake Forest,81,12,Chattanooga,58,23,1993
Round of 64,Southeast,8,Utah,86,9,Pittsburgh,85,1,1993
Round of 64,West,1,Michigan,84,16,Coastal Carolina,53,31,1993
Round of 64,West,9,UCLA,81,8,Iowa State,70,11,1993
Round of 64,West,12,George Washington,82,5,New Mexico,68,14,1993
Round of 64,West,13,Southern,93,4,Georgia Tech,78,15,1993
Round of 32,East,1,North Carolina,112,8,Rhode Island,67,45,1993
Round of 32,East,4,Arkansas,80,5,"St. John's, New York",74,6,1993
Round of 32,Midwest,2,Kansas,90,7,Brigham Young,76,14,1993
Round of 32,Midwest,6,California,82,3,Duke,77,5,1993
Round of 32,Southeast,3,Florida State,94,11,Tulane,63,31,1993
Round of 32,Southeast,7,Western Kentucky,72,2,Seton Hall,68,4,1993
Round of 32,West,3,Vanderbilt,85,6,Illinois,68,17,1993
Round of 32,West,7,Temple,68,15,Santa Clara,57,11,1993
Round of 32,East,2,Cincinnati,92,7,New Mexico State,55,37,1993
Round of 32,East,6,Virginia,71,3,Massachusetts,56,15,1993
Round of 32,Midwest,1,Indiana,73,9,"Xavier, Ohio",70,3,1993
Round of 32,Midwest,4,Louisville,78,5,Oklahoma State,63,15,1993
Round of 32,Southeast,1,Kentucky,83,8,Utah,62,21,1993
Round of 32,Southeast,5,Wake Forest,84,4,Iowa,78,6,1993
Round of 32,West,1,Michigan,86,9,UCLA,84,2,1993
Round of 32,West,12,George Washington,90,13,Southern,80,10,1993
Sweet Sixteen,Midwest,1,Indiana,82,4,Louisville,69,13,1993
Sweet Sixteen,Midwest,2,Kansas,93,6,California,76,17,1993
Sweet Sixteen,Southeast,1,Kentucky,103,5,Wake Forest,69,34,1993
Sweet Sixteen,Southeast,3,Florida State,81,7,Western Kentucky,78,3,1993
Sweet Sixteen,East,1,North Carolina,80,4,Arkansas,74,6,1993
Sweet Sixteen,East,2,Cincinnati,71,6,Virginia,54,17,1993
Sweet Sixteen,West,1,Michigan,72,12,George Washington,64,8,1993
Sweet Sixteen,West,7,Temple,67,3,Vanderbilt,59,8,1993
Elite Eight,Midwest,2,Kansas,83,1,Indiana,77,6,1993
Elite Eight,Southeast,1,Kentucky,106,3,Florida State,81,25,1993
Elite Eight,East,1,North Carolina,75,2,Cincinnati,68,7,1993
Elite Eight,West,1,Michigan,77,7,Temple,72,5,1993
National Semifinals,National Semifinals,1,North Carolina,78,2,Kansas,68,10,1993
National Semifinals,National Semifinals,1,Michigan,81,1,Kentucky,78,3,1993
National Championship,National Championship,1,North Carolina,77,1,Michigan,71,6,1993
Round of 64,East,2,Connecticut,64,15,Rider,46,18,1994
Round of 64,East,3,Florida,64,14,James Madison,62,2,1994
Round of 64,East,10,George Washington,51,7,UAB,46,5,1994
Round of 64,East,11,Pennsylvania,90,6,Nebraska,80,10,1994
Round of 64,Midwest,2,Massachusetts,78,15,Texas State,60,18,1994
Round of 64,Midwest,3,Michigan,78,14,Pepperdine,74,4,1994
Round of 64,Midwest,6,Texas,91,11,Western Kentucky,77,14,1994
Round of 64,Midwest,10,Maryland,74,7,St. Louis,66,8,1994
Round of 64,Southeast,1,Purdue,98,16,Central Florida,67,31,1994
Round of 64,Southeast,4,Kansas,102,13,Chattanooga,73,29,1994
Round of 64,Southeast,5,Wake Forest,68,12,"Charleston, South Carolina",58,10,1994
Round of 64,Southeast,9,Alabama,76,8,Providence,70,6,1994
Round of 64,West,1,Missouri,76,16,Navy,53,23,1994
Round of 64,West,4,Syracuse,92,13,Hawaii,78,14,1994
Round of 64,West,9,Wisconsin,80,8,Cincinnati,72,8,1994
Round of 64,West,12,Green Bay,61,5,California,57,4,1994
Round of 64,East,1,North Carolina,71,16,Liberty,51,20,1994
Round of 64,East,4,Temple,61,13,Drexel,39,22,1994
Round of 64,East,5,Indiana,84,12,Ohio,72,12,1994
Round of 64,East,9,Boston College,67,8,Washington State,64,3,1994
Round of 64,Midwest,1,Arkansas,94,16,North Carolina A&T,79,15,1994
Round of 64,Midwest,4,Oklahoma State,65,13,New Mexico State,55,10,1994
Round of 64,Midwest,9,Georgetown,84,8,Illinois,77,7,1994
Round of 64,Midwest,12,Tulsa,112,5,UCLA,102,10,1994
Round of 64,Southeast,2,Duke,82,15,Texas Southern,70,12,1994
Round of 64,Southeast,3,Kentucky,83,14,Tennessee State,70,13,1994
Round of 64,Southeast,6,Marquette,81,11,Louisiana-Lafayette,59,22,1994
Round of 64,Southeast,7,Michigan State,84,10,Seton Hall,73,11,1994
Round of 64,West,2,Arizona,81,15,"Loyola, Maryland",55,26,1994
Round of 64,West,3,Louisville,67,14,Boise State,58,9,1994
Round of 64,West,6,Minnesota,74,11,Southern Illinois,60,14,1994
Round of 64,West,7,Virginia,57,10,New Mexico,54,3,1994
Round of 32,East,2,Connecticut,75,10,George Washington,63,12,1994
Round of 32,East,3,Florida,70,11,Pennsylvania,58,12,1994
Round of 32,Midwest,3,Michigan,84,6,Texas,79,5,1994
Round of 32,Midwest,10,Maryland,95,2,Massachusetts,87,8,1994
Round of 32,Southeast,1,Purdue,83,9,Alabama,73,10,1994
Round of 32,Southeast,4,Kansas,69,5,Wake Forest,58,11,1994
Round of 32,West,1,Missouri,109,9,Wisconsin,96,13,1994
Round of 32,West,4,Syracuse,64,12,Green Bay,59,5,1994
Round of 32,East,5,Indiana,67,4,Temple,58,9,1994
Round of 32,East,9,Boston College,75,1,North Carolina,72,3,1994
Round of 32,Midwest,1,Arkansas,85,9,Georgetown,73,12,1994
Round of 32,Midwest,12,Tulsa,82,4,Oklahoma State,80,2,1994
Round of 32,Southeast,2,Duke,85,7,Michigan State,74,11,1994
Round of 32,Southeast,6,Marquette,75,3,Kentucky,63,12,1994
Round of 32,West,2,Arizona,71,7,Virginia,58,13,1994
Round of 32,West,3,Louisville,60,6,Minnesota,55,5,1994
Sweet Sixteen,Southeast,1,Purdue,83,4,Kansas,78,5,1994
Sweet Sixteen,Southeast,2,Duke,59,6,Marquette,49,10,1994
Sweet Sixteen,West,1,Missouri,98,4,Syracuse,88,10,1994
Sweet Sixteen,West,2,Arizona,82,3,Louisville,70,12,1994
Sweet Sixteen,East,3,Florida,69,2,Connecticut,60,9,1994
Sweet Sixteen,East,9,Boston College,77,5,Indiana,68,9,1994
Sweet Sixteen,Midwest,1,Arkansas,103,12,Tulsa,84,19,1994
Sweet Sixteen,Midwest,3,Michigan,78,10,Maryland,71,7,1994
Elite Eight,Southeast,2,Duke,69,1,Purdue,60,9,1994
Elite Eight,West,2,Arizona,92,1,Missouri,72,20,1994
Elite Eight,East,3,Florida,74,9,Boston College,66,8,1994
Elite Eight,Midwest,1,Arkansas,76,3,Michigan,68,8,1994
National Semifinals,National Semifinals,1,Arkansas,91,2,Arizona,82,9,1994
National Semifinals,National Semifinals,2,Duke,70,3,Florida,65,5,1994
National Championship,National Championship,1,Arkansas,76,2,Duke,72,4,1994
Round of 64,East,1,Wake Forest,79,16,North Carolina A&T,47,32,1995
Round of 64,East,4,Oklahoma State,73,13,Drexel,49,24,1995
Round of 64,East,5,Alabama,91,12,Pennsylvania,85,6,1995
Round of 64,East,9,St. Louis,64,8,Minnesota,61,3,1995
Round of 64,Midwest,1,Kansas,82,16,Colgate,68,14,1995
Round of 64,Midwest,4,Virginia,96,13,Nicholls State,72,24,1995
Round of 64,Midwest,8,Western Kentucky,82,9,Michigan,76,6,1995
Round of 64,Midwest,12,"Miami, Ohio",71,5,Arizona,62,9,1995
Round of 64,Southeast,1,Kentucky,113,16,"Mt. St. Mary's, Maryland",67,46,1995
Round of 64,Southeast,5,Arizona State,81,12,Ball State,66,15,1995
Round of 64,Southeast,9,Tulane,76,8,Brigham Young,70,6,1995
Round of 64,Southeast,13,Manhattan,77,4,Oklahoma,67,10,1995
Round of 64,West,2,Connecticut,100,15,Chattanooga,71,29,1995
Round of 64,West,3,Maryland,87,14,Gonzaga,63,24,1995
Round of 64,West,7,Cincinnati,77,10,Temple,71,6,1995
Round of 64,West,11,Texas,90,6,Oregon,73,17,1995
Round of 64,East,2,Massachusetts,68,15,St. Peter's,51,17,1995
Round of 64,East,6,Tulsa,68,11,Illinois,62,6,1995
Round of 64,East,10,Stanford,70,7,Charlotte,68,2,1995
Round of 64,East,14,Old Dominion,89,3,Villanova,81,8,1995
Round of 64,Midwest,2,Arkansas,79,15,Texas Southern,78,1,1995
Round of 64,Midwest,3,Purdue,49,14,Green Bay,48,1,1995
Round of 64,Midwest,6,Memphis,77,11,Louisville,56,21,1995
Round of 64,Midwest,7,Syracuse,96,10,Southern Illinois,92,4,1995
Round of 64,Southeast,2,North Carolina,80,15,Murray State,70,10,1995
Round of 64,Southeast,6,Georgetown,68,11,"Xavier, Ohio",63,5,1995
Round of 64,Southeast,7,Iowa State,64,10,Florida,61,3,1995
Round of 64,Southeast,14,Weber State,79,3,Michigan State,72,7,1995
Round of 64,West,1,UCLA,92,16,Florida International,56,36,1995
Round of 64,West,4,Utah,76,13,Long Beach State,64,12,1995
Round of 64,West,5,Mississippi State,75,12,Santa Clara,67,8,1995
Round of 64,West,8,Missouri,65,9,Indiana,60,5,1995
Round of 32,East,1,Wake Forest,64,9,St. Louis,59,5,1995
Round of 32,East,4,Oklahoma State,66,5,Alabama,52,14,1995
Round of 32,Midwest,1,Kansas,75,8,Western Kentucky,70,5,1995
Round of 32,Midwest,4,Virginia,60,12,"Miami, Ohio",54,6,1995
Round of 32,Southeast,1,Kentucky,82,9,Tulane,60,22,1995
Round of 32,Southeast,5,Arizona State,64,13,Manhattan,54,10,1995
Round of 32,West,2,Connecticut,96,7,Cincinnati,91,5,1995
Round of 32,West,3,Maryland,82,11,Texas,68,14,1995
Round of 32,East,2,Massachusetts,75,10,Stanford,53,22,1995
Round of 32,East,6,Tulsa,64,14,Old Dominion,52,12,1995
Round of 32,Midwest,2,Arkansas,96,7,Syracuse,94,2,1995
Round of 32,Midwest,6,Memphis,75,3,Purdue,73,2,1995
Round of 32,Southeast,2,North Carolina,73,7,Iowa State,51,22,1995
Round of 32,Southeast,6,Georgetown,53,14,Weber State,51,2,1995
Round of 32,West,1,UCLA,75,8,Missouri,74,1,1995
Round of 32,West,5,Mississippi State,78,4,Utah,64,14,1995
Sweet Sixteen,Southeast,1,Kentucky,97,5,Arizona State,73,24,1995
Sweet Sixteen,Southeast,2,North Carolina,74,6,Georgetown,64,10,1995
Sweet Sixteen,West,1,UCLA,86,5,Mississippi State,67,19,1995
Sweet Sixteen,West,2,Connecticut,99,3,Maryland,89,10,1995
Sweet Sixteen,East,2,Massachusetts,76,6,Tulsa,51,25,1995
Sweet Sixteen,East,4,Oklahoma State,71,1,Wake Forest,66,5,1995
Sweet Sixteen,Midwest,2,Arkansas,96,6,Memphis,91,5,1995
Sweet Sixteen,Midwest,4,Virginia,67,1,Kansas,58,9,1995
Elite Eight,Southeast,2,North Carolina,74,1,Kentucky,61,13,1995
Elite Eight,West,1,UCLA,102,2,Connecticut,96,6,1995
Elite Eight,East,4,Oklahoma State,68,2,Massachusetts,54,14,1995
Elite Eight,Midwest,2,Arkansas,68,4,Virginia,61,7,1995
National Semifinals,National Semifinals,1,UCLA,74,4,Oklahoma State,61,13,1995
National Semifinals,National Semifinals,2,Arkansas,75,2,North Carolina,68,7,1995
National Championship,National Championship,1,UCLA,89,2,Arkansas,78,11,1995
Round of 64,East,1,Massachusetts,92,16,Central Florida,70,22,1996
Round of 64,East,4,Marquette,68,13,"Monmouth, New Jersey",44,24,1996
Round of 64,East,9,Stanford,66,8,Bradley,58,8,1996
Round of 64,East,12,Arkansas,86,5,Pennsylvania State,80,6,1996
Round of 64,Midwest,1,Kentucky,110,16,San Jose State,72,38,1996
Round of 64,Midwest,4,Utah,72,13,Canisius,43,29,1996
Round of 64,Midwest,5,Iowa State,74,12,California,64,10,1996
Round of 64,Midwest,9,Virginia Tech,61,8,Green Bay,48,13,1996
Round of 64,Southeast,1,Connecticut,68,16,Colgate,59,9,1996
Round of 64,Southeast,5,Mississippi State,58,12,Virginia Commonwealth,51,7,1996
Round of 64,Southeast,9,Eastern Michigan,75,8,Duke,60,15,1996
Round of 64,Southeast,13,Princeton,43,4,UCLA,41,2,1996
Round of 64,West,1,Purdue,73,16,Western Carolina,71,2,1996
Round of 64,West,4,Syracuse,88,13,Montana State,55,33,1996
Round of 64,West,8,Georgia,81,9,Clemson,74,7,1996
Round of 64,West,12,Drexel,75,5,Memphis,63,12,1996
Round of 64,East,2,Georgetown,93,15,Mississippi Valley,56,37,1996
Round of 64,East,3,Texas Tech,74,14,Northern Illinois,73,1,1996
Round of 64,East,6,North Carolina,83,11,New Orleans,62,21,1996
Round of 64,East,7,New Mexico,69,10,Kansas State,48,21,1996
Round of 64,Midwest,2,Wake Forest,62,15,Louisiana-Monroe,50,12,1996
Round of 64,Midwest,3,Villanova,92,14,Portland,58,34,1996
Round of 64,Midwest,6,Louisville,82,11,Tulsa,80,2,1996
Round of 64,Midwest,10,Texas,80,7,Michigan,76,4,1996
Round of 64,Southeast,2,Cincinnati,66,15,North Carolina-Greensboro,61,5,1996
Round of 64,Southeast,3,Georgia Tech,90,14,Austin Peay,79,11,1996
Round of 64,Southeast,7,Temple,61,10,Oklahoma,43,18,1996
Round of 64,Southeast,11,Boston College,64,6,Indiana,51,13,1996
Round of 64,West,2,Kansas,92,15,South Carolina State,54,38,1996
Round of 64,West,3,Arizona,90,14,Valparaiso,51,39,1996
Round of 64,West,6,Iowa,81,11,George Washington,79,2,1996
Round of 64,West,10,Santa Clara,91,7,Maryland,79,12,1996
Round of 32,East,1,Massachusetts,79,9,Stanford,74,5,1996
Round of 32,East,12,Arkansas,65,4,Marquette,56,9,1996
Round of 32,Midwest,1,Kentucky,84,9,Virginia Tech,60,24,1996
Round of 32,Midwest,4,Utah,73,5,Iowa State,67,6,1996
Round of 32,Southeast,1,Connecticut,95,9,Eastern Michigan,81,14,1996
Round of 32,Southeast,5,Mississippi State,63,13,Princeton,41,22,1996
Round of 32,West,4,Syracuse,69,12,Drexel,58,11,1996
Round of 32,West,8,Georgia,76,1,Purdue,69,7,1996
Round of 32,East,2,Georgetown,73,7,New Mexico,62,11,1996
Round of 32,East,3,Texas Tech,92,6,North Carolina,73,19,1996
Round of 32,Midwest,2,Wake Forest,65,10,Texas,62,3,1996
Round of 32,Midwest,6,Louisville,68,3,Villanova,64,4,1996
Round of 32,Southeast,2,Cincinnati,78,7,Temple,65,13,1996
Round of 32,Southeast,3,Georgia Tech,103,11,Boston College,89,14,1996
Round of 32,West,2,Kansas,76,10,Santa Clara,51,25,1996
Round of 32,West,3,Arizona,87,6,Iowa,73,14,1996
Sweet Sixteen,East,1,Massachusetts,79,12,Arkansas,63,16,1996
Sweet Sixteen,East,2,Georgetown,98,3,Texas Tech,90,8,1996
Sweet Sixteen,Midwest,1,Kentucky,101,4,Utah,70,31,1996
Sweet Sixteen,Midwest,2,Wake Forest,60,6,Louisville,59,1,1996
Sweet Sixteen,Southeast,2,Cincinnati,87,3,Georgia Tech,70,17,1996
Sweet Sixteen,Southeast,5,Mississippi State,60,1,Connecticut,55,5,1996
Sweet Sixteen,West,2,Kansas,83,3,Arizona,80,3,1996
Sweet Sixteen,West,4,Syracuse,83,8,Georgia,81,2,1996
Elite Eight,East,1,Massachusetts,86,2,Georgetown,62,24,1996
Elite Eight,Midwest,1,Kentucky,83,2,Wake Forest,63,20,1996
Elite Eight,Southeast,5,Mississippi State,73,2,Cincinnati,63,10,1996
Elite Eight,West,4,Syracuse,60,2,Kansas,57,3,1996
National Semifinals,National Semifinals,1,Kentucky,81,1,Massachusetts,74,7,1996
National Semifinals,National Semifinals,4,Syracuse,77,5,Mississippi State,69,8,1996
National Championship,National Championship,1,Kentucky,76,4,Syracuse,67,9,1996
Round of 64,East,1,North Carolina,82,16,Fairfield,74,8,1997
Round of 64,East,4,Villanova,101,13,Long Island-Brooklyn,91,10,1997
Round of 64,East,5,California,55,12,Princeton,52,3,1997
Round of 64,East,9,Colorado,80,8,Indiana,62,18,1997
Round of 64,Midwest,2,UCLA,109,15,Charleston Southern,75,34,1997
Round of 64,Midwest,3,Cincinnati,86,14,Butler,69,17,1997
Round of 64,Midwest,6,Iowa State,69,11,Illinois State,57,12,1997
Round of 64,Midwest,7,"Xavier, Ohio",80,10,Vanderbilt,68,12,1997
Round of 64,Southeast,1,Kansas,78,16,Jackson State,64,14,1997
Round of 64,Southeast,4,Arizona,65,13,South Alabama,57,8,1997
Round of 64,Southeast,8,Purdue,83,9,Rhode Island,76,7,1997
Round of 64,Southeast,12,"Charleston, South Carolina",75,5,Maryland,66,9,1997
Round of 64,West,1,Kentucky,92,16,Montana,54,38,1997
Round of 64,West,4,"St. Joseph's, Pennsylvania",75,13,"Pacific, California",65,10,1997
Round of 64,West,5,Boston College,73,12,Valparaiso,66,7,1997
Round of 64,West,8,Iowa,73,9,Virginia,60,13,1997
Round of 64,East,3,New Mexico,59,14,Old Dominion,55,4,1997
Round of 64,East,6,Louisville,65,11,Massachusetts,57,8,1997
Round of 64,East,10,Texas,71,7,Wisconsin,58,13,1997
Round of 64,East,15,Coppin State,78,2,South Carolina,65,13,1997
Round of 64,Midwest,1,Minnesota,78,16,Texas State,46,32,1997
Round of 64,Midwest,4,Clemson,68,13,"Miami, Ohio",56,12,1997
Round of 64,Midwest,5,Tulsa,81,12,Boston,52,29,1997
Round of 64,Midwest,9,Temple,62,8,Mississippi,40,22,1997
Round of 64,Southeast,2,Duke,81,15,Murray State,78,3,1997
Round of 64,Southeast,6,Illinois,90,11,Southern California,77,13,1997
Round of 64,Southeast,10,Providence,81,7,Marquette,59,22,1997
Round of 64,Southeast,14,Chattanooga,73,3,Georgia,70,3,1997
Round of 64,West,2,Utah,75,15,Navy,61,14,1997
Round of 64,West,3,Wake Forest,68,14,"St. Mary's, California",46,22,1997
Round of 64,West,6,Stanford,80,11,Oklahoma,67,13,1997
Round of 64,West,7,Charlotte,79,10,Georgetown,67,12,1997
Round of 32,East,1,North Carolina,73,9,Colorado,56,17,1997
Round of 32,East,5,California,75,4,Villanova,68,7,1997
Round of 32,Midwest,2,UCLA,96,7,"Xavier, Ohio",83,13,1997
Round of 32,Midwest,6,Iowa State,67,3,Cincinnati,66,1,1997
Round of 32,Southeast,1,Kansas,75,8,Purdue,61,14,1997
Round of 32,Southeast,4,Arizona,73,12,"Charleston, South Carolina",69,4,1997
Round of 32,West,1,Kentucky,75,8,Iowa,69,6,1997
Round of 32,West,4,"St. Joseph's, Pennsylvania",81,5,Boston College,77,4,1997
Round of 32,East,6,Louisville,64,3,New Mexico,63,1,1997
Round of 32,East,10,Texas,82,15,Coppin State,81,1,1997
Round of 32,Midwest,1,Minnesota,76,9,Temple,57,19,1997
Round of 32,Midwest,4,Clemson,65,5,Tulsa,59,6,1997
Round of 32,Southeast,10,Providence,98,2,Duke,87,11,1997
Round of 32,Southeast,14,Chattanooga,75,6,Illinois,63,12,1997
Round of 32,West,2,Utah,77,7,Charlotte,58,19,1997
Round of 32,West,6,Stanford,72,3,Wake Forest,66,6,1997
Sweet Sixteen,Midwest,1,Minnesota,90,4,Clemson,84,6,1997
Sweet Sixteen,Midwest,2,UCLA,74,6,Iowa State,73,1,1997
Sweet Sixteen,West,1,Kentucky,83,4,"St. Joseph's, Pennsylvania",68,15,1997
Sweet Sixteen,West,2,Utah,82,6,Stanford,77,5,1997
Sweet Sixteen,East,1,North Carolina,73,5,California,67,6,1997
Sweet Sixteen,East,6,Louisville,78,10,Texas,63,15,1997
Sweet Sixteen,Southeast,4,Arizona,85,1,Kansas,82,3,1997
Sweet Sixteen,Southeast,10,Providence,71,14,Chattanooga,65,6,1997
Elite Eight,Midwest,1,Minnesota,80,2,UCLA,72,8,1997
Elite Eight,West,1,Kentucky,72,2,Utah,59,13,1997
Elite Eight,East,1,North Carolina,97,6,Louisville,74,23,1997
Elite Eight,Southeast,4,Arizona,96,10,Providence,92,4,1997
National Semifinals,National Semifinals,1,Kentucky,78,1,Minnesota,69,9,1997
National Semifinals,National Semifinals,4,Arizona,66,1,North Carolina,58,8,1997
National Championship,National Championship,4,Arizona,84,1,Kentucky,79,5,1997
Round of 64,East,1,North Carolina,88,16,Navy,52,36,1998
Round of 64,East,2,Connecticut,93,15,Fairleigh Dickinson,85,8,1998
Round of 64,East,4,Michigan State,83,13,Eastern Michigan,71,12,1998
Round of 64,East,5,Princeton,69,12,Nevada-Las Vegas,57,12,1998
Round of 64,East,7,Indiana,94,10,Oklahoma,87,7,1998
Round of 64,East,8,Charlotte,77,9,Illinois-Chicago,62,15,1998
Round of 64,East,11,Washington,69,6,"Xavier, Ohio",68,1,1998
Round of 64,East,14,Richmond,62,3,South Carolina,61,1,1998
Round of 64,West,1,Arizona,99,16,Nicholls State,60,39,1998
Round of 64,West,2,Cincinnati,65,15,Northern Arizona,62,3,1998
Round of 64,West,3,Utah,85,14,San Francisco,68,17,1998
Round of 64,West,4,Maryland,82,13,Utah State,68,14,1998
Round of 64,West,5,Illinois,64,12,South Alabama,51,13,1998
Round of 64,West,6,Arkansas,74,11,Nebraska,65,9,1998
Round of 64,West,9,Illinois State,82,8,Tennessee,81,1,1998
Round of 64,West,10,West Virginia,82,7,Temple,52,30,1998
Round of 64,Midwest,1,Kansas,110,16,Prairie View,52,58,1998
Round of 64,Midwest,2,Purdue,95,15,Delaware,56,39,1998
Round of 64,Midwest,3,Stanford,67,14,"Charleston, South Carolina",57,10,1998
Round of 64,Midwest,8,Rhode Island,97,9,Murray State,74,23,1998
Round of 64,Midwest,10,Detroit,66,7,"St. John's, New York",64,2,1998
Round of 64,Midwest,11,Western Michigan,75,6,Clemson,72,3,1998
Round of 64,Midwest,12,Florida State,96,5,Texas Christian,87,9,1998
Round of 64,Midwest,13,Valparaiso,70,4,Mississippi,69,1,1998
Round of 64,South,1,Duke,99,16,Radford,63,36,1998
Round of 64,South,2,Kentucky,82,15,South Carolina State,67,15,1998
Round of 64,South,3,Michigan,80,14,Davidson,61,19,1998
Round of 64,South,4,New Mexico,79,13,Butler,62,17,1998
Round of 64,South,5,Syracuse,63,12,Iona,61,2,1998
Round of 64,South,6,UCLA,65,11,"Miami, Florida",62,3,1998
Round of 64,South,8,Oklahoma State,74,9,George Washington,59,15,1998
Round of 64,South,10,St. Louis,51,7,Massachusetts,46,5,1998
Round of 32,East,1,North Carolina,93,8,Charlotte,83,10,1998
Round of 32,East,2,Connecticut,78,7,Indiana,68,10,1998
Round of 32,East,4,Michigan State,63,5,Princeton,56,7,1998
Round of 32,East,11,Washington,87,14,Richmond,66,21,1998
Round of 32,West,1,Arizona,82,9,Illinois State,49,33,1998
Round of 32,West,3,Utah,75,6,Arkansas,69,6,1998
Round of 32,West,4,Maryland,67,5,Illinois,61,6,1998
Round of 32,West,10,West Virginia,75,2,Cincinnati,74,1,1998
Round of 32,Midwest,2,Purdue,80,10,Detroit,65,15,1998
Round of 32,Midwest,3,Stanford,83,11,Western Michigan,65,18,1998
Round of 32,Midwest,8,Rhode Island,80,1,Kansas,75,5,1998
Round of 32,Midwest,13,Valparaiso,83,12,Florida State,77,6,1998
Round of 32,South,1,Duke,79,8,Oklahoma State,73,6,1998
Round of 32,South,2,Kentucky,88,10,St. Louis,61,27,1998
Round of 32,South,5,Syracuse,56,4,New Mexico,46,10,1998
Round of 32,South,6,UCLA,85,3,Michigan,82,3,1998
Sweet Sixteen,East,1,North Carolina,73,4,Michigan State,58,15,1998
Sweet Sixteen,East,2,Connecticut,75,11,Washington,74,1,1998
Sweet Sixteen,West,1,Arizona,87,4,Maryland,79,8,1998
Sweet Sixteen,West,3,Utah,65,10,West Virginia,62,3,1998
Sweet Sixteen,Midwest,3,Stanford,67,2,Purdue,59,8,1998
Sweet Sixteen,Midwest,8,Rhode Island,74,13,Valparaiso,68,6,1998
Sweet Sixteen,South,1,Duke,80,5,Syracuse,67,13,1998
Sweet Sixteen,South,2,Kentucky,94,6,UCLA,68,26,1998
Elite Eight,East,1,North Carolina,75,2,Connecticut,64,11,1998
Elite Eight,West,3,Utah,76,1,Arizona,51,25,1998
Elite Eight,Midwest,3,Stanford,79,8,Rhode Island,77,2,1998
Elite Eight,South,2,Kentucky,86,1,Duke,84,2,1998
National Semifinals,National Semifinals,2,Kentucky,86,3,Stanford,85,1,1998
National Semifinals,National Semifinals,3,Utah,65,1,North Carolina,59,6,1998
National Championship,National Championship,2,Kentucky,78,3,Utah,69,9,1998
Round of 64,South,1,Auburn,80,16,Winthrop,41,39,1999
Round of 64,South,2,Maryland,82,15,Valparaiso,60,22,1999
Round of 64,South,3,"St. John's, New York",69,14,Samford,43,26,1999
Round of 64,South,4,Ohio State,72,13,Murray State,58,14,1999
Round of 64,South,6,Indiana,108,11,George Washington,88,20,1999
Round of 64,South,9,Oklahoma State,69,8,Syracuse,61,8,1999
Round of 64,South,10,Creighton,62,7,Louisville,58,4,1999
Round of 64,South,12,Detroit,56,5,UCLA,53,3,1999
Round of 64,West,1,Connecticut,91,16,Texas-San Antonio,66,25,1999
Round of 64,West,2,Stanford,69,15,Alcorn State,57,12,1999
Round of 64,West,4,Arkansas,94,13,Siena,80,14,1999
Round of 64,West,5,Iowa,77,12,UAB,64,13,1999
Round of 64,West,6,Florida,75,11,Pennsylvania,61,14,1999
Round of 64,West,9,New Mexico,61,8,Missouri,59,2,1999
Round of 64,West,10,Gonzaga,75,7,Minnesota,63,12,1999
Round of 64,West,14,Weber State,76,3,North Carolina,74,2,1999
Round of 64,East,1,Duke,99,16,Florida A&M,58,41,1999
Round of 64,East,2,"Miami, Florida",75,15,Lafayette,54,21,1999
Round of 64,East,3,Cincinnati,72,14,George Mason,48,24,1999
Round of 64,East,4,Tennessee,62,13,Delaware,52,10,1999
Round of 64,East,6,Temple,61,11,Kent State,54,7,1999
Round of 64,East,9,Tulsa,62,8,"Charleston, South Carolina",53,9,1999
Round of 64,East,10,Purdue,58,7,Texas,54,4,1999
Round of 64,East,12,Missouri State,43,5,Wisconsin,32,11,1999
Round of 64,Midwest,1,Michigan State,76,16,"Mt. St. Mary's, Maryland",53,23,1999
Round of 64,Midwest,2,Utah,80,15,Arkansas State,58,22,1999
Round of 64,Midwest,3,Kentucky,82,14,New Mexico State,60,22,1999
Round of 64,Midwest,5,Charlotte,81,12,Rhode Island,70,11,1999
Round of 64,Midwest,6,Kansas,95,11,Evansville,74,21,1999
Round of 64,Midwest,9,Mississippi,72,8,Villanova,70,2,1999
Round of 64,Midwest,10,"Miami, Ohio",59,7,Washington,58,1,1999
Round of 64,Midwest,13,Oklahoma,61,4,Arizona,60,1,1999
Round of 32,South,1,Auburn,81,9,Oklahoma State,74,7,1999
Round of 32,South,2,Maryland,75,10,Creighton,63,12,1999
Round of 32,South,3,"St. John's, New York",86,6,Indiana,61,25,1999
Round of 32,South,4,Ohio State,75,12,Detroit,44,31,1999
Round of 32,West,1,Connecticut,78,9,New Mexico,56,22,1999
Round of 32,West,5,Iowa,82,4,Arkansas,72,10,1999
Round of 32,West,6,Florida,82,14,Weber State,74,8,1999
Round of 32,West,10,Gonzaga,82,2,Stanford,74,8,1999
Round of 32,East,1,Duke,97,9,Tulsa,56,41,1999
Round of 32,East,6,Temple,64,3,Cincinnati,54,10,1999
Round of 32,East,10,Purdue,73,2,"Miami, Florida",63,10,1999
Round of 32,East,12,Missouri State,81,4,Tennessee,51,30,1999
Round of 32,Midwest,1,Michigan State,74,9,Mississippi,66,8,1999
Round of 32,Midwest,3,Kentucky,92,6,Kansas,88,4,1999
Round of 32,Midwest,10,"Miami, Ohio",66,2,Utah,58,8,1999
Round of 32,Midwest,13,Oklahoma,85,5,Charlotte,72,13,1999
Sweet Sixteen,South,3,"St. John's, New York",76,2,Maryland,62,14,1999
Sweet Sixteen,South,4,Ohio State,72,1,Auburn,64,8,1999
Sweet Sixteen,West,1,Connecticut,78,5,Iowa,68,10,1999
Sweet Sixteen,West,10,Gonzaga,73,6,Florida,72,1,1999
Sweet Sixteen,East,1,Duke,78,12,Missouri State,61,17,1999
Sweet Sixteen,East,6,Temple,77,10,Purdue,55,22,1999
Sweet Sixteen,Midwest,1,Michigan State,54,13,Oklahoma,46,8,1999
Sweet Sixteen,Midwest,3,Kentucky,58,10,"Miami, Ohio",43,15,1999
Elite Eight,South,4,Ohio State,77,3,"St. John's, New York",74,3,1999
Elite Eight,West,1,Connecticut,67,10,Gonzaga,62,5,1999
Elite Eight,East,1,Duke,85,6,Temple,64,21,1999
Elite Eight,Midwest,1,Michigan State,73,3,Kentucky,66,7,1999
National Semifinals,National Semifinals,1,Duke,68,1,Michigan State,62,6,1999
National Semifinals,National Semifinals,1,Connecticut,64,4,Ohio State,58,6,1999
National Championship,National Championship,1,Connecticut,77,1,Duke,74,3,1999
Round of 64,Midwest,1,Michigan State,65,16,Valparaiso,38,27,2000
Round of 64,Midwest,2,Iowa State,88,15,Central Connecticut State,78,10,2000
Round of 64,Midwest,3,Maryland,74,14,Iona,59,15,2000
Round of 64,Midwest,4,Syracuse,79,13,Samford,65,14,2000
Round of 64,Midwest,5,Kentucky,85,12,St. Bonaventure,80,5,2000
Round of 64,Midwest,6,UCLA,65,11,Ball State,57,8,2000
Round of 64,Midwest,7,Auburn,72,10,Creighton,69,3,2000
Round of 64,Midwest,8,Utah,48,9,St. Louis,45,3,2000
Round of 64,West,1,Arizona,71,16,Jackson State,47,24,2000
Round of 64,West,2,"St. John's, New York",61,15,Northern Arizona,56,5,2000
Round of 64,West,3,Oklahoma,74,14,Winthrop,60,14,2000
Round of 64,West,4,Louisiana State,64,13,Southeast Missouri State,61,3,2000
Round of 64,West,5,Texas,77,12,Indiana State,61,16,2000
Round of 64,West,6,Purdue,62,11,Dayton,61,1,2000
Round of 64,West,8,Wisconsin,66,9,Fresno State,56,10,2000
Round of 64,West,10,Gonzaga,77,7,Louisville,66,11,2000
Round of 64,East,1,Duke,82,16,Lamar,55,27,2000
Round of 64,East,2,Temple,73,15,Lafayette,47,26,2000
Round of 64,East,3,Oklahoma State,86,14,Hofstra,66,20,2000
Round of 64,East,4,Illinois,68,13,Pennsylvania,58,10,2000
Round of 64,East,5,Florida,69,12,Butler,68,1,2000
Round of 64,East,8,Kansas,81,9,DePaul,77,4,2000
Round of 64,East,10,Seton Hall,72,7,Oregon,71,1,2000
Round of 64,East,11,Pepperdine,77,6,Indiana,57,20,2000
Round of 64,South,1,Stanford,84,16,South Carolina State,65,19,2000
Round of 64,South,2,Cincinnati,64,15,North Carolina-Wilmington,47,17,2000
Round of 64,South,3,Ohio State,87,14,Appalachian State,61,26,2000
Round of 64,South,4,Tennessee,63,13,Louisiana-Lafayette,58,5,2000
Round of 64,South,5,Connecticut,75,12,Utah State,67,8,2000
Round of 64,South,6,"Miami, Florida",75,11,Arkansas,71,4,2000
Round of 64,South,7,Tulsa,89,10,Nevada-Las Vegas,62,27,2000
Round of 64,South,8,North Carolina,84,9,Missouri,70,14,2000
Round of 32,Midwest,1,Michigan State,73,8,Utah,61,12,2000
Round of 32,Midwest,2,Iowa State,79,7,Auburn,60,19,2000
Round of 32,Midwest,4,Syracuse,52,5,Kentucky,50,2,2000
Round of 32,Midwest,6,UCLA,105,3,Maryland,70,35,2000
Round of 32,West,4,Louisiana State,72,5,Texas,67,5,2000
Round of 32,West,6,Purdue,66,3,Oklahoma,62,4,2000
Round of 32,West,8,Wisconsin,66,1,Arizona,59,7,2000
Round of 32,West,10,Gonzaga,82,2,"St. John's, New York",76,6,2000
Round of 32,East,1,Duke,69,8,Kansas,64,5,2000
Round of 32,East,3,Oklahoma State,75,11,Pepperdine,67,8,2000
Round of 32,East,5,Florida,93,4,Illinois,76,17,2000
Round of 32,East,10,Seton Hall,67,2,Temple,65,2,2000
Round of 32,South,4,Tennessee,65,5,Connecticut,51,14,2000
Round of 32,South,6,"Miami, Florida",75,3,Ohio State,62,13,2000
Round of 32,South,7,Tulsa,69,2,Cincinnati,61,8,2000
Round of 32,South,8,North Carolina,60,1,Stanford,53,7,2000
Sweet Sixteen,Midwest,1,Michigan State,75,4,Syracuse,58,17,2000
Sweet Sixteen,Midwest,2,Iowa State,80,6,UCLA,56,24,2000
Sweet Sixteen,West,6,Purdue,75,10,Gonzaga,66,9,2000
Sweet Sixteen,West,8,Wisconsin,61,4,Louisiana State,48,13,2000
Sweet Sixteen,East,3,Oklahoma State,68,10,Seton Hall,66,2,2000
Sweet Sixteen,East,5,Florida,87,1,Duke,78,9,2000
Sweet Sixteen,South,7,Tulsa,80,6,"Miami, Florida",71,9,2000
Sweet Sixteen,South,8,North Carolina,74,4,Tennessee,69,5,2000
Elite Eight,Midwest,1,Michigan State,75,2,Iowa State,64,11,2000
Elite Eight,West,8,Wisconsin,64,6,Purdue,60,4,2000
Elite Eight,East,5,Florida,77,3,Oklahoma State,65,12,2000
Elite Eight,South,8,North Carolina,59,7,Tulsa,55,4,2000
National Semifinals,National Semifinals,1,Michigan State,53,8,Wisconsin,41,12,2000
National Semifinals,National Semifinals,5,Florida,71,8,North Carolina,59,12,2000
National Championship,National Championship,1,Michigan State,89,5,Florida,76,13,2000
Opening Round,Midwest,16,Northwestern State,71,16,Winthrop,67,4,2001
Round of 64,East,1,Duke,95,16,"Monmouth, New Jersey",52,43,2001
Round of 64,East,2,Kentucky,72,15,Holy Cross,68,4,2001
Round of 64,East,3,Boston College,68,14,Southern Utah,65,3,2001
Round of 64,East,4,UCLA,61,13,Hofstra,48,13,2001
Round of 64,East,6,Southern California,69,11,Oklahoma State,54,15,2001
Round of 64,East,7,Iowa,69,10,Creighton,56,13,2001
Round of 64,East,9,Missouri,70,8,Georgia,68,2,2001
Round of 64,East,12,Utah State,77,5,Ohio State,68,9,2001
Round of 64,West,1,Stanford,89,16,North Carolina-Greensboro,60,29,2001
Round of 64,West,3,Maryland,83,14,George Mason,80,3,2001
Round of 64,West,5,Cincinnati,84,12,Brigham Young,59,25,2001
Round of 64,West,9,"St. Joseph's, Pennsylvania",66,8,Georgia Tech,62,4,2001
Round of 64,West,10,Georgetown,63,7,Arkansas,61,2,2001
Round of 64,West,11,Georgia State,50,6,Wisconsin,49,1,2001
Round of 64,West,13,Kent State,77,4,Indiana,73,4,2001
Round of 64,West,15,Hampton,58,2,Iowa State,57,1,2001
Round of 64,Midwest,1,Illinois,96,16,Northwestern State,54,42,2001
Round of 64,Midwest,2,Arizona,101,15,Eastern Illinois,76,25,2001
Round of 64,Midwest,3,Mississippi,72,14,Iona,70,2,2001
Round of 64,Midwest,4,Kansas,99,13,California State-Northridge,75,24,2001
Round of 64,Midwest,5,Syracuse,79,12,Hawaii,69,10,2001
Round of 64,Midwest,6,Notre Dame,83,11,"Xavier, Ohio",71,12,2001
Round of 64,Midwest,9,Charlotte,70,8,Tennessee,63,7,2001
Round of 64,Midwest,10,Butler,79,7,Wake Forest,63,16,2001
Round of 64,South,1,Michigan State,69,16,Alabama State,35,34,2001
Round of 64,South,2,North Carolina,70,15,Princeton,48,22,2001
Round of 64,South,3,Florida,69,14,Western Kentucky,56,13,2001
Round of 64,South,7,Pennsylvania State,69,10,Providence,59,10,2001
Round of 64,South,9,Fresno State,82,8,California,70,12,2001
Round of 64,South,11,Temple,79,6,Texas,65,14,2001
Round of 64,South,12,Gonzaga,86,5,Virginia,85,1,2001
Round of 64,South,13,Indiana State,70,4,Oklahoma,68,2,2001
Round of 32,East,1,Duke,94,9,Missouri,81,13,2001
Round of 32,East,2,Kentucky,92,7,Iowa,79,13,2001
Round of 32,East,4,UCLA,75,12,Utah State,70,5,2001
Round of 32,East,6,Southern California,74,3,Boston College,71,3,2001
Round of 32,West,1,Stanford,90,9,"St. Joseph's, Pennsylvania",83,7,2001
Round of 32,West,3,Maryland,79,11,Georgia State,60,19,2001
Round of 32,West,5,Cincinnati,66,13,Kent State,43,23,2001
Round of 32,West,10,Georgetown,76,15,Hampton,57,19,2001
Round of 32,Midwest,1,Illinois,79,9,Charlotte,61,18,2001
Round of 32,Midwest,2,Arizona,73,10,Butler,52,21,2001
Round of 32,Midwest,3,Mississippi,59,6,Notre Dame,56,3,2001
Round of 32,Midwest,4,Kansas,87,5,Syracuse,58,29,2001
Round of 32,South,1,Michigan State,81,9,Fresno State,65,16,2001
Round of 32,South,7,Pennsylvania State,82,2,North Carolina,74,8,2001
Round of 32,South,11,Temple,75,3,Florida,54,21,2001
Round of 32,South,12,Gonzaga,85,13,Indiana State,68,17,2001
Sweet Sixteen,East,1,Duke,76,4,UCLA,63,13,2001
Sweet Sixteen,East,6,Southern California,80,2,Kentucky,76,4,2001
Sweet Sixteen,West,1,Stanford,78,5,Cincinnati,65,13,2001
Sweet Sixteen,West,3,Maryland,76,10,Georgetown,66,10,2001
Sweet Sixteen,Midwest,1,Illinois,80,4,Kansas,64,16,2001
Sweet Sixteen,Midwest,2,Arizona,66,3,Mississippi,56,10,2001
Sweet Sixteen,South,1,Michigan State,77,12,Gonzaga,62,15,2001
Sweet Sixteen,South,11,Temple,84,7,Pennsylvania State,72,12,2001
Elite Eight,East,1,Duke,79,6,Southern California,69,10,2001
Elite Eight,West,3,Maryland,87,1,Stanford,73,14,2001
Elite Eight,Midwest,2,Arizona,87,1,Illinois,81,6,2001
Elite Eight,South,1,Michigan State,69,11,Temple,62,7,2001
National Semifinals,National Semifinals,1,Duke,95,3,Maryland,84,11,2001
National Semifinals,National Semifinals,2,Arizona,80,1,Michigan State,61,19,2001
National Championship,National Championship,1,Duke,82,2,Arizona,72,10,2001
Opening Round,East,16,Siena,81,16,Alcorn State,77,4,2002
Round of 64,East,4,Kentucky,83,13,Valparaiso,68,15,2002
Round of 64,East,12,Tulsa,71,5,Marquette,69,2,2002
Round of 64,Midwest,1,Kansas,70,16,Holy Cross,59,11,2002
Round of 64,Midwest,2,Oregon,81,15,Montana,62,19,2002
Round of 64,Midwest,7,Wake Forest,83,10,Pepperdine,74,9,2002
Round of 64,Midwest,8,Stanford,84,9,Western Kentucky,68,16,2002
Round of 64,South,1,Duke,84,16,Winthrop,37,47,2002
Round of 64,South,2,Alabama,86,15,Florida Atlantic,78,8,2002
Round of 64,South,5,Indiana,75,12,Utah,56,19,2002
Round of 64,South,8,Notre Dame,82,9,Charlotte,63,19,2002
Round of 64,South,10,Kent State,69,7,Oklahoma State,61,8,2002
Round of 64,South,13,North Carolina-Wilmington,93,4,Southern California,89,4,2002
Round of 64,West,3,Arizona,86,14,California-Santa Barbara,81,5,2002
Round of 64,West,4,Ohio State,69,13,Davidson,64,5,2002
Round of 64,West,11,Wyoming,73,6,Gonzaga,66,7,2002
Round of 64,West,12,Missouri,93,5,"Miami, Florida",80,13,2002
Round of 64,East,1,Maryland,85,16,Siena,70,15,2002
Round of 64,East,2,Connecticut,78,15,Hampton,67,11,2002
Round of 64,East,3,Georgia,85,14,Murray State,68,17,2002
Round of 64,East,7,North Carolina State,69,10,Michigan State,58,11,2002
Round of 64,East,8,Wisconsin,80,9,"St. John's, New York",70,10,2002
Round of 64,East,11,Southern Illinois,76,6,Texas Tech,68,8,2002
Round of 64,Midwest,3,Mississippi State,70,14,McNeese State,58,12,2002
Round of 64,Midwest,4,Illinois,93,13,San Diego State,64,29,2002
Round of 64,Midwest,6,Texas,70,11,Boston College,57,13,2002
Round of 64,Midwest,12,Creighton,83,5,Florida,82,1,2002
Round of 64,South,3,Pittsburgh,71,14,Central Connecticut State,54,17,2002
Round of 64,South,6,California,82,11,Pennsylvania,75,7,2002
Round of 64,West,1,Cincinnati,90,16,Boston,52,38,2002
Round of 64,West,2,Oklahoma,71,15,Illinois-Chicago,63,8,2002
Round of 64,West,7,"Xavier, Ohio",70,10,Hawaii,58,12,2002
Round of 64,West,8,UCLA,80,9,Mississippi,58,22,2002
Round of 32,East,4,Kentucky,87,12,Tulsa,82,5,2002
Round of 32,Midwest,1,Kansas,86,8,Stanford,63,23,2002
Round of 32,Midwest,2,Oregon,92,7,Wake Forest,87,5,2002
Round of 32,South,1,Duke,84,8,Notre Dame,77,7,2002
Round of 32,South,5,Indiana,76,13,North Carolina-Wilmington,67,9,2002
Round of 32,South,10,Kent State,71,2,Alabama,58,13,2002
Round of 32,West,3,Arizona,68,11,Wyoming,60,8,2002
Round of 32,West,12,Missouri,83,4,Ohio State,67,16,2002
Round of 32,East,1,Maryland,87,8,Wisconsin,57,30,2002
Round of 32,East,2,Connecticut,77,7,North Carolina State,74,3,2002
Round of 32,East,11,Southern Illinois,77,3,Georgia,75,2,2002
Round of 32,Midwest,4,Illinois,72,12,Creighton,60,12,2002
Round of 32,Midwest,6,Texas,68,3,Mississippi State,64,4,2002
Round of 32,South,3,Pittsburgh,63,6,California,50,13,2002
Round of 32,West,2,Oklahoma,78,7,"Xavier, Ohio",65,13,2002
Round of 32,West,8,UCLA,105,1,Cincinnati,101,4,2002
Sweet Sixteen,South,5,Indiana,74,1,Duke,73,1,2002
Sweet Sixteen,South,10,Kent State,78,3,Pittsburgh,73,5,2002
Sweet Sixteen,West,2,Oklahoma,88,3,Arizona,67,21,2002
Sweet Sixteen,West,12,Missouri,82,8,UCLA,73,9,2002
Sweet Sixteen,East,1,Maryland,78,4,Kentucky,68,10,2002
Sweet Sixteen,East,2,Connecticut,71,11,Southern Illinois,59,12,2002
Sweet Sixteen,Midwest,1,Kansas,73,4,Illinois,69,4,2002
Sweet Sixteen,Midwest,2,Oregon,72,6,Texas,70,2,2002
Elite Eight,South,5,Indiana,81,10,Kent State,69,12,2002
Elite Eight,West,2,Oklahoma,81,12,Missouri,75,6,2002
Elite Eight,East,1,Maryland,90,2,Connecticut,82,8,2002
Elite Eight,Midwest,1,Kansas,104,2,Oregon,86,18,2002
National Semifinals,National Semifinals,1,Maryland,97,1,Kansas,88,9,2002
National Semifinals,National Semifinals,5,Indiana,73,2,Oklahoma,64,9,2002
National Championship,National Championship,1,Maryland,64,5,Indiana,52,12,2002
Opening Round,South,16,North Carolina-Asheville,92,16,Texas Southern,84,8,2003
Round of 64,East,1,Oklahoma,71,16,South Carolina State,54,17,2003
Round of 64,East,8,California,76,9,North Carolina State,74,2,2003
Round of 64,Midwest,3,Marquette,72,14,Holy Cross,68,4,2003
Round of 64,Midwest,5,Wisconsin,81,12,Weber State,74,7,2003
Round of 64,Midwest,6,Missouri,72,11,Southern Illinois,71,1,2003
Round of 64,Midwest,13,Tulsa,84,4,Dayton,71,13,2003
Round of 64,South,4,Stanford,77,13,San Diego,69,8,2003
Round of 64,South,5,Connecticut,58,12,Brigham Young,53,5,2003
Round of 64,West,1,Arizona,80,16,Vermont,51,29,2003
Round of 64,West,2,Kansas,64,15,Utah State,61,3,2003
Round of 64,West,3,Duke,67,14,Colorado State,57,10,2003
Round of 64,West,4,Illinois,65,13,Western Kentucky,60,5,2003
Round of 64,West,5,Notre Dame,70,12,Milwaukee,69,1,2003
Round of 64,West,9,Gonzaga,74,8,Cincinnati,69,5,2003
Round of 64,West,10,Arizona State,84,7,Memphis,71,13,2003
Round of 64,West,11,Central Michigan,79,6,Creighton,73,6,2003
Round of 64,East,2,Wake Forest,76,15,East Tennessee State,73,3,2003
Round of 64,East,3,Syracuse,76,14,Manhattan,65,11,2003
Round of 64,East,4,Louisville,86,13,Austin Peay,64,22,2003
Round of 64,East,6,Oklahoma State,77,11,Pennsylvania,63,14,2003
Round of 64,East,10,Auburn,65,7,"St. Joseph's, Pennsylvania",63,2,2003
Round of 64,East,12,Butler,47,5,Mississippi State,46,1,2003
Round of 64,Midwest,1,Kentucky,95,16,IUPUI,64,31,2003
Round of 64,Midwest,2,Pittsburgh,87,15,Wagner,61,26,2003
Round of 64,Midwest,7,Indiana,67,10,Alabama,62,5,2003
Round of 64,Midwest,9,Utah,60,8,Oregon,58,2,2003
Round of 64,South,1,Texas,82,16,North Carolina-Asheville,61,21,2003
Round of 64,South,2,Florida,85,15,Sam Houston State,55,30,2003
Round of 64,South,3,"Xavier, Ohio",71,14,Troy,59,12,2003
Round of 64,South,6,Maryland,75,11,North Carolina-Wilmington,73,2,2003
Round of 64,South,7,Michigan State,79,10,Colorado,64,15,2003
Round of 64,South,9,Purdue,80,8,Louisiana State,56,24,2003
Round of 32,East,1,Oklahoma,74,8,California,65,9,2003
Round of 32,Midwest,3,Marquette,101,6,Missouri,92,9,2003
Round of 32,Midwest,5,Wisconsin,61,13,Tulsa,60,1,2003
Round of 32,South,5,Connecticut,85,4,Stanford,74,11,2003
Round of 32,West,1,Arizona,96,9,Gonzaga,95,1,2003
Round of 32,West,2,Kansas,108,10,Arizona State,76,32,2003
Round of 32,West,3,Duke,86,11,Central Michigan,60,26,2003
Round of 32,West,5,Notre Dame,68,4,Illinois,60,8,2003
Round of 32,East,3,Syracuse,68,6,Oklahoma State,56,12,2003
Round of 32,East,10,Auburn,68,2,Wake Forest,62,6,2003
Round of 32,East,12,Butler,79,4,Louisville,71,8,2003
Round of 32,Midwest,1,Kentucky,74,9,Utah,54,20,2003
Round of 32,Midwest,2,Pittsburgh,74,7,Indiana,52,22,2003
Round of 32,South,1,Texas,77,9,Purdue,67,10,2003
Round of 32,South,6,Maryland,77,3,"Xavier, Ohio",64,13,2003
Round of 32,South,7,Michigan State,68,2,Florida,46,22,2003
Sweet Sixteen,Midwest,1,Kentucky,63,5,Wisconsin,57,6,2003
Sweet Sixteen,Midwest,3,Marquette,77,2,Pittsburgh,74,3,2003
Sweet Sixteen,West,1,Arizona,88,5,Notre Dame,71,17,2003
Sweet Sixteen,West,2,Kansas,69,3,Duke,65,4,2003
Sweet Sixteen,East,1,Oklahoma,65,12,Butler,54,11,2003
Sweet Sixteen,East,3,Syracuse,79,10,Auburn,78,1,2003
Sweet Sixteen,South,1,Texas,82,5,Connecticut,78,4,2003
Sweet Sixteen,South,7,Michigan State,60,6,Maryland,58,2,2003
Elite Eight,Midwest,3,Marquette,83,1,Kentucky,69,14,2003
Elite Eight,West,2,Kansas,78,1,Arizona,75,3,2003
Elite Eight,East,3,Syracuse,63,1,Oklahoma,47,16,2003
Elite Eight,South,1,Texas,85,7,Michigan State,76,9,2003
National Semifinals,National Semifinals,2,Kansas,94,3,Marquette,61,33,2003
National Semifinals,National Semifinals,3,Syracuse,95,1,Texas,84,11,2003
National Championship,National Championship,3,Syracuse,81,2,Kansas,78,3,2003
Opening Round,Midwest,16,Florida A&M,72,16,Lehigh,57,15,2004
Round of 64,East,1,"St. Joseph's, Pennsylvania",82,16,Liberty,63,19,2004
Round of 64,East,4,Wake Forest,79,13,Virginia Commonwealth,78,1,2004
Round of 64,East,8,Texas Tech,76,9,Charlotte,73,3,2004
Round of 64,East,12,Manhattan,75,5,Florida,60,15,2004
Round of 64,Midwest,2,Gonzaga,76,15,Valparaiso,49,27,2004
Round of 64,Midwest,10,Nevada,72,7,Michigan State,66,6,2004
Round of 64,South,1,Duke,96,16,Alabama State,61,35,2004
Round of 64,South,3,Texas,66,14,Princeton,49,17,2004
Round of 64,South,6,North Carolina,63,11,Air Force,52,11,2004
Round of 64,South,8,Seton Hall,80,9,Arizona,76,4,2004
Round of 64,West,1,Stanford,71,16,Texas-San Antonio,45,26,2004
Round of 64,West,2,Connecticut,70,15,Vermont,53,17,2004
Round of 64,West,4,Maryland,86,13,Texas-El Paso,83,3,2004
Round of 64,West,5,Syracuse,80,12,Brigham Young,75,5,2004
Round of 64,West,7,DePaul,76,10,Dayton,69,7,2004
Round of 64,West,8,Alabama,65,9,Southern Illinois,64,1,2004
Round of 64,East,2,Oklahoma State,75,15,Eastern Washington,56,19,2004
Round of 64,East,3,Pittsburgh,53,14,Central Florida,44,9,2004
Round of 64,East,6,Wisconsin,76,11,Richmond,64,12,2004
Round of 64,East,7,Memphis,59,10,South Carolina,43,16,2004
Round of 64,Midwest,1,Kentucky,96,16,Florida A&M,76,20,2004
Round of 64,Midwest,3,Georgia Tech,65,14,Northern Iowa,60,5,2004
Round of 64,Midwest,4,Kansas,78,13,Illinois-Chicago,53,25,2004
Round of 64,Midwest,6,Boston College,58,11,Utah,51,7,2004
Round of 64,Midwest,9,UAB,102,8,Washington,100,2,2004
Round of 64,Midwest,12,"Pacific, California",66,5,Providence,58,8,2004
Round of 64,South,2,Mississippi State,85,15,"Monmouth, New Jersey",52,33,2004
Round of 64,South,4,Cincinnati,80,13,East Tennessee State,77,3,2004
Round of 64,South,5,Illinois,72,12,Murray State,53,19,2004
Round of 64,South,7,"Xavier, Ohio",80,10,Louisville,70,10,2004
Round of 64,West,3,North Carolina State,61,14,Louisiana-Lafayette,52,9,2004
Round of 64,West,6,Vanderbilt,71,11,Western Michigan,58,13,2004
Round of 32,East,1,"St. Joseph's, Pennsylvania",70,8,Texas Tech,65,5,2004
Round of 32,East,4,Wake Forest,84,12,Manhattan,80,4,2004
Round of 32,Midwest,10,Nevada,91,2,Gonzaga,72,19,2004
Round of 32,South,1,Duke,90,8,Seton Hall,62,28,2004
Round of 32,South,3,Texas,78,6,North Carolina,75,3,2004
Round of 32,West,2,Connecticut,72,7,DePaul,55,17,2004
Round of 32,West,5,Syracuse,72,4,Maryland,70,2,2004
Round of 32,West,8,Alabama,70,1,Stanford,67,3,2004
Round of 32,East,2,Oklahoma State,70,7,Memphis,53,17,2004
Round of 32,East,3,Pittsburgh,59,6,Wisconsin,55,4,2004
Round of 32,Midwest,3,Georgia Tech,57,6,Boston College,54,3,2004
Round of 32,Midwest,4,Kansas,78,12,"Pacific, California",63,15,2004
Round of 32,Midwest,9,UAB,76,1,Kentucky,75,1,2004
Round of 32,South,5,Illinois,92,4,Cincinnati,68,24,2004
Round of 32,South,7,"Xavier, Ohio",89,2,Mississippi State,74,15,2004
Round of 32,West,6,Vanderbilt,75,3,North Carolina State,73,2,2004
Sweet Sixteen,East,1,"St. Joseph's, Pennsylvania",84,4,Wake Forest,80,4,2004
Sweet Sixteen,East,2,Oklahoma State,63,3,Pittsburgh,51,12,2004
Sweet Sixteen,West,2,Connecticut,73,6,Vanderbilt,53,20,2004
Sweet Sixteen,West,8,Alabama,80,5,Syracuse,71,9,2004
Sweet Sixteen,Midwest,3,Georgia Tech,72,10,Nevada,67,5,2004
Sweet Sixteen,Midwest,4,Kansas,100,9,UAB,74,26,2004
Sweet Sixteen,South,1,Duke,72,5,Illinois,62,10,2004
Sweet Sixteen,South,7,"Xavier, Ohio",79,3,Texas,71,8,2004
Elite Eight,East,2,Oklahoma State,64,1,"St. Joseph's, Pennsylvania",62,2,2004
Elite Eight,West,2,Connecticut,87,8,Alabama,71,16,2004
Elite Eight,Midwest,3,Georgia Tech,79,4,Kansas,71,8,2004
Elite Eight,South,1,Duke,66,7,"Xavier, Ohio",63,3,2004
National Semifinals,National Semifinals,2,Connecticut,79,1,Duke,78,1,2004
National Semifinals,National Semifinals,3,Georgia Tech,67,2,Oklahoma State,65,2,2004
National Championship,National Championship,2,Connecticut,82,3,Georgia Tech,73,9,2004
Opening Round,East,16,Oakland,79,16,Alabama A&M,69,10,2005
Round of 64,Midwest,1,Illinois,67,16,Fairleigh Dickinson,55,12,2005
Round of 64,Midwest,3,Arizona,66,14,Utah State,53,13,2005
Round of 64,Midwest,4,Boston College,85,13,Pennsylvania,65,20,2005
Round of 64,Midwest,9,Nevada,61,8,Texas,57,4,2005
Round of 64,Midwest,11,UAB,82,6,Louisiana State,68,14,2005
Round of 64,Midwest,12,Milwaukee,83,5,Alabama,73,10,2005
Round of 64,South,2,Kentucky,72,15,Eastern Kentucky,64,8,2005
Round of 64,South,3,Oklahoma,84,14,Niagara,67,17,2005
Round of 64,South,6,Utah,60,11,Texas-El Paso,54,6,2005
Round of 64,South,7,Cincinnati,76,10,Iowa,64,12,2005
Round of 64,West,1,Washington,88,16,Montana,77,11,2005
Round of 64,West,2,Wake Forest,70,15,Chattanooga,54,16,2005
Round of 64,West,3,Gonzaga,74,14,Winthrop,64,10,2005
Round of 64,West,6,Texas Tech,78,11,UCLA,66,12,2005
Round of 64,West,7,West Virginia,63,10,Creighton,61,2,2005
Round of 64,West,8,"Pacific, California",79,9,Pittsburgh,71,8,2005
Round of 64,East,1,North Carolina,96,16,Oakland,68,28,2005
Round of 64,East,2,Connecticut,77,15,Central Florida,71,6,2005
Round of 64,East,4,Florida,67,13,Ohio,62,5,2005
Round of 64,East,5,Villanova,55,12,New Mexico,47,8,2005
Round of 64,East,6,Wisconsin,57,11,Northern Iowa,52,5,2005
Round of 64,East,9,Iowa State,64,8,Minnesota,53,11,2005
Round of 64,East,10,North Carolina State,75,7,Charlotte,63,12,2005
Round of 64,East,14,Bucknell,64,3,Kansas,63,1,2005
Round of 64,Midwest,2,Oklahoma State,63,15,Southeastern Louisiana,50,13,2005
Round of 64,Midwest,7,Southern Illinois,65,10,"St. Mary's, California",56,9,2005
Round of 64,South,1,Duke,57,16,Delaware State,46,11,2005
Round of 64,South,5,Michigan State,89,12,Old Dominion,81,8,2005
Round of 64,South,9,Mississippi State,93,8,Stanford,70,23,2005
Round of 64,South,13,Vermont,60,4,Syracuse,57,3,2005
Round of 64,West,4,Louisville,68,13,Louisiana-Lafayette,62,6,2005
Round of 64,West,5,Georgia Tech,80,12,George Washington,68,12,2005
Round of 32,Midwest,1,Illinois,71,9,Nevada,59,12,2005
Round of 32,Midwest,3,Arizona,85,11,UAB,63,22,2005
Round of 32,Midwest,12,Milwaukee,83,4,Boston College,75,8,2005
Round of 32,South,2,Kentucky,69,7,Cincinnati,60,9,2005
Round of 32,South,6,Utah,67,3,Oklahoma,58,9,2005
Round of 32,West,1,Washington,97,8,"Pacific, California",79,18,2005
Round of 32,West,6,Texas Tech,71,3,Gonzaga,69,2,2005
Round of 32,West,7,West Virginia,111,2,Wake Forest,105,6,2005
Round of 32,East,1,North Carolina,92,9,Iowa State,65,27,2005
Round of 32,East,5,Villanova,76,4,Florida,65,11,2005
Round of 32,East,6,Wisconsin,71,14,Bucknell,62,9,2005
Round of 32,East,10,North Carolina State,65,2,Connecticut,62,3,2005
Round of 32,Midwest,2,Oklahoma State,85,7,Southern Illinois,77,8,2005
Round of 32,South,1,Duke,63,9,Mississippi State,55,8,2005
Round of 32,South,5,Michigan State,72,13,Vermont,61,11,2005
Round of 32,West,4,Louisville,76,5,Georgia Tech,54,22,2005
Sweet Sixteen,Midwest,1,Illinois,77,12,Milwaukee,63,14,2005
Sweet Sixteen,Midwest,3,Arizona,79,2,Oklahoma State,78,1,2005
Sweet Sixteen,West,4,Louisville,93,1,Washington,79,14,2005
Sweet Sixteen,West,7,West Virginia,65,6,Texas Tech,60,5,2005
Sweet Sixteen,East,1,North Carolina,67,5,Villanova,66,1,2005
Sweet Sixteen,East,6,Wisconsin,65,10,North Carolina State,56,9,2005
Sweet Sixteen,South,2,Kentucky,62,6,Utah,52,10,2005
Sweet Sixteen,South,5,Michigan State,78,1,Duke,68,10,2005
Elite Eight,Midwest,1,Illinois,90,3,Arizona,89,1,2005
Elite Eight,West,4,Louisville,93,7,West Virginia,85,8,2005
Elite Eight,East,1,North Carolina,88,6,Wisconsin,82,6,2005
Elite Eight,South,5,Michigan State,94,2,Kentucky,88,6,2005
National Semifinals,National Semifinals,1,North Carolina,87,5,Michigan State,71,16,2005
National Semifinals,National Semifinals,1,Illinois,72,4,Louisville,57,15,2005
National Championship,National Championship,1,North Carolina,75,1,Illinois,70,5,2005
Opening Round,Midwest,16,"Monmouth, New Jersey",71,16,Hampton,49,22,2006
Round of 64,East,2,Tennessee,63,15,Winthrop,61,2,2006
Round of 64,East,4,Illinois,78,13,Air Force,69,9,2006
Round of 64,East,5,Washington,75,12,Utah State,61,14,2006
Round of 64,East,7,Wichita State,86,10,Seton Hall,66,20,2006
Round of 64,Midwest,3,Florida,76,14,South Alabama,50,26,2006
Round of 64,Midwest,4,Boston College,88,13,"Pacific, California",76,12,2006
Round of 64,Midwest,11,Milwaukee,82,6,Oklahoma,74,8,2006
Round of 64,Midwest,12,Montana,87,5,Nevada,79,8,2006
Round of 64,South,1,Duke,70,16,Southern,54,16,2006
Round of 64,South,4,Louisiana State,80,13,Iona,64,16,2006
Round of 64,South,8,George Washington,88,9,North Carolina-Wilmington,85,3,2006
Round of 64,South,12,Texas A&M,66,5,Syracuse,58,8,2006
Round of 64,West,2,UCLA,78,15,Belmont,44,34,2006
Round of 64,West,3,Gonzaga,79,14,"Xavier, Ohio",75,4,2006
Round of 64,West,6,Indiana,87,11,San Diego State,83,4,2006
Round of 64,West,10,Alabama,90,7,Marquette,85,5,2006
Round of 64,East,1,Connecticut,72,16,Albany,59,13,2006
Round of 64,East,3,North Carolina,69,14,Murray State,65,4,2006
Round of 64,East,8,Kentucky,69,9,UAB,64,5,2006
Round of 64,East,11,George Mason,75,6,Michigan State,65,10,2006
Round of 64,Midwest,1,Villanova,58,16,"Monmouth, New Jersey",45,13,2006
Round of 64,Midwest,2,Ohio State,70,15,Davidson,62,8,2006
Round of 64,Midwest,7,Georgetown,54,10,Northern Iowa,49,5,2006
Round of 64,Midwest,8,Arizona,94,9,Wisconsin,75,19,2006
Round of 64,South,2,Texas,60,15,Pennsylvania,52,8,2006
Round of 64,South,6,West Virginia,64,11,Southern Illinois,46,18,2006
Round of 64,South,10,North Carolina State,58,7,California,52,6,2006
Round of 64,South,14,Northwestern State,64,3,Iowa,63,1,2006
Round of 64,West,1,Memphis,94,16,Oral Roberts,78,16,2006
Round of 64,West,5,Pittsburgh,79,12,Kent State,64,15,2006
Round of 64,West,9,Bucknell,59,8,Arkansas,55,4,2006
Round of 64,West,13,Bradley,77,4,Kansas,73,4,2006
Round of 32,East,5,Washington,67,4,Illinois,64,3,2006
Round of 32,East,7,Wichita State,80,2,Tennessee,73,7,2006
Round of 32,Midwest,3,Florida,82,11,Milwaukee,60,22,2006
Round of 32,Midwest,4,Boston College,69,12,Montana,56,13,2006
Round of 32,South,1,Duke,74,8,George Washington,61,13,2006
Round of 32,South,4,Louisiana State,58,12,Texas A&M,57,1,2006
Round of 32,West,2,UCLA,62,10,Alabama,59,3,2006
Round of 32,West,3,Gonzaga,90,6,Indiana,80,10,2006
Round of 32,East,1,Connecticut,87,8,Kentucky,83,4,2006
Round of 32,East,11,George Mason,65,3,North Carolina,60,5,2006
Round of 32,Midwest,1,Villanova,82,8,Arizona,78,4,2006
Round of 32,Midwest,7,Georgetown,70,2,Ohio State,52,18,2006
Round of 32,South,2,Texas,75,10,North Carolina State,54,21,2006
Round of 32,South,6,West Virginia,67,14,Northwestern State,54,13,2006
Round of 32,West,1,Memphis,72,9,Bucknell,56,16,2006
Round of 32,West,13,Bradley,72,5,Pittsburgh,66,6,2006
Sweet Sixteen,South,2,Texas,74,6,West Virginia,71,3,2006
Sweet Sixteen,South,4,Louisiana State,62,1,Duke,54,8,2006
Sweet Sixteen,West,1,Memphis,80,13,Bradley,64,16,2006
Sweet Sixteen,West,2,UCLA,73,3,Gonzaga,71,2,2006
Sweet Sixteen,East,1,Connecticut,98,5,Washington,92,6,2006
Sweet Sixteen,East,11,George Mason,63,7,Wichita State,55,8,2006
Sweet Sixteen,Midwest,1,Villanova,60,4,Boston College,59,1,2006
Sweet Sixteen,Midwest,3,Florida,57,7,Georgetown,53,4,2006
Elite Eight,South,4,Louisiana State,70,2,Texas,60,10,2006
Elite Eight,West,2,UCLA,50,1,Memphis,45,5,2006
Elite Eight,East,11,George Mason,86,1,Connecticut,84,2,2006
Elite Eight,Midwest,3,Florida,75,1,Villanova,62,13,2006
National Semifinals,National Semifinals,2,UCLA,59,4,Louisiana State,45,14,2006
National Semifinals,National Semifinals,3,Florida,73,11,George Mason,58,15,2006
National Championship,National Championship,3,Florida,73,2,UCLA,57,16,2006
Opening Round,West,16,Niagara,77,16,Florida A&M,69,8,2007
Round of 64,East,1,North Carolina,86,16,Eastern Kentucky,65,21,2007
Round of 64,East,2,Georgetown,80,15,Belmont,55,25,2007
Round of 64,East,3,Washington State,70,14,Oral Roberts,54,16,2007
Round of 64,East,6,Vanderbilt,77,11,George Washington,44,33,2007
Round of 64,East,7,Boston College,84,10,Texas Tech,75,9,2007
Round of 64,East,9,Michigan State,61,8,Marquette,49,12,2007
Round of 64,Midwest,4,Maryland,82,13,Davidson,70,12,2007
Round of 64,Midwest,5,Butler,57,12,Old Dominion,46,11,2007
Round of 64,South,1,Ohio State,78,16,Central Connecticut State,57,21,2007
Round of 64,South,3,Texas A&M,68,14,Pennsylvania,52,16,2007
Round of 64,South,6,Louisville,78,11,Stanford,58,20,2007
Round of 64,South,9,"Xavier, Ohio",79,8,Brigham Young,77,2,2007
Round of 64,West,2,UCLA,70,15,Weber State,42,28,2007
Round of 64,West,3,Pittsburgh,79,14,Wright State,58,21,2007
Round of 64,West,7,Indiana,70,10,Gonzaga,57,13,2007
Round of 64,West,11,Virginia Commonwealth,79,6,Duke,77,2,2007
Round of 64,East,4,Texas,79,13,New Mexico State,67,12,2007
Round of 64,East,5,Southern California,77,12,Arkansas,60,17,2007
Round of 64,Midwest,1,Florida,112,16,Jackson State,69,43,2007
Round of 64,Midwest,2,Wisconsin,76,15,Texas A&M-Corpus Christi,63,13,2007
Round of 64,Midwest,3,Oregon,58,14,"Miami, Ohio",56,2,2007
Round of 64,Midwest,7,Nevada-Las Vegas,67,10,Georgia Tech,63,4,2007
Round of 64,Midwest,9,Purdue,72,8,Arizona,63,9,2007
Round of 64,Midwest,11,Winthrop,74,6,Notre Dame,64,10,2007
Round of 64,South,2,Memphis,73,15,North Texas,58,15,2007
Round of 64,South,4,Virginia,84,13,Albany,57,27,2007
Round of 64,South,5,Tennessee,121,12,Long Beach State,86,35,2007
Round of 64,South,7,Nevada,77,10,Creighton,71,6,2007
Round of 64,West,1,Kansas,107,16,Niagara,67,40,2007
Round of 64,West,4,Southern Illinois,61,13,Holy Cross,51,10,2007
Round of 64,West,5,Virginia Tech,54,12,Illinois,52,2,2007
Round of 64,West,8,Kentucky,67,9,Villanova,58,9,2007
Round of 32,East,1,North Carolina,81,9,Michigan State,67,14,2007
Round of 32,East,2,Georgetown,62,7,Boston College,55,7,2007
Round of 32,East,6,Vanderbilt,78,3,Washington State,74,4,2007
Round of 32,Midwest,5,Butler,62,4,Maryland,59,3,2007
Round of 32,South,1,Ohio State,78,9,"Xavier, Ohio",71,7,2007
Round of 32,South,3,Texas A&M,72,6,Louisville,69,3,2007
Round of 32,West,2,UCLA,54,7,Indiana,49,5,2007
Round of 32,West,3,Pittsburgh,84,11,Virginia Commonwealth,79,5,2007
Round of 32,East,5,Southern California,87,4,Texas,68,19,2007
Round of 32,Midwest,1,Florida,74,9,Purdue,67,7,2007
Round of 32,Midwest,3,Oregon,75,11,Winthrop,61,14,2007
Round of 32,Midwest,7,Nevada-Las Vegas,74,2,Wisconsin,68,6,2007
Round of 32,South,2,Memphis,78,7,Nevada,62,16,2007
Round of 32,South,5,Tennessee,77,4,Virginia,74,3,2007
Round of 32,West,1,Kansas,88,8,Kentucky,76,12,2007
Round of 32,West,4,Southern Illinois,63,5,Virginia Tech,48,15,2007
Sweet Sixteen,South,1,Ohio State,85,5,Tennessee,84,1,2007
Sweet Sixteen,South,2,Memphis,65,3,Texas A&M,64,1,2007
Sweet Sixteen,West,1,Kansas,61,4,Southern Illinois,58,3,2007
Sweet Sixteen,West,2,UCLA,64,3,Pittsburgh,55,9,2007
Sweet Sixteen,East,1,North Carolina,74,5,Southern California,64,10,2007
Sweet Sixteen,East,2,Georgetown,66,6,Vanderbilt,65,1,2007
Sweet Sixteen,Midwest,1,Florida,65,5,Butler,57,8,2007
Sweet Sixteen,Midwest,3,Oregon,76,7,Nevada-Las Vegas,72,4,2007
Elite Eight,South,1,Ohio State,92,2,Memphis,76,16,2007
Elite Eight,West,2,UCLA,68,1,Kansas,55,13,2007
Elite Eight,East,2,Georgetown,96,1,North Carolina,84,12,2007
Elite Eight,Midwest,1,Florida,85,3,Oregon,77,8,2007
National Semifinals,National Semifinals,1,Florida,76,2,UCLA,66,10,2007
National Semifinals,National Semifinals,1,Ohio State,67,2,Georgetown,60,7,2007
National Championship,National Championship,1,Florida,84,1,Ohio State,75,9,2007
Opening Round,East,16,"Mt. St. Mary's, Maryland",69,16,Coppin State,60,9,2008
Round of 64,East,4,Washington State,71,13,Winthrop,40,31,2008
Round of 64,East,5,Notre Dame,68,12,George Mason,50,18,2008
Round of 64,Midwest,1,Kansas,85,16,Portland State,61,24,2008
Round of 64,Midwest,3,Wisconsin,71,14,California State-Fullerton,56,15,2008
Round of 64,Midwest,8,Nevada-Las Vegas,71,9,Kent State,58,13,2008
Round of 64,Midwest,11,Kansas State,80,6,Southern California,67,13,2008
Round of 64,South,3,Stanford,77,14,Cornell,53,24,2008
Round of 64,South,4,Pittsburgh,82,13,Oral Roberts,63,19,2008
Round of 64,South,5,Michigan State,72,12,Temple,61,11,2008
Round of 64,South,6,Marquette,74,11,Kentucky,66,8,2008
Round of 64,West,1,UCLA,70,16,Mississippi Valley,29,41,2008
Round of 64,West,2,Duke,71,15,Belmont,70,1,2008
Round of 64,West,3,"Xavier, Ohio",73,14,Georgia,61,12,2008
Round of 64,West,6,Purdue,90,11,Baylor,79,11,2008
Round of 64,West,7,West Virginia,75,10,Arizona,65,10,2008
Round of 64,West,9,Texas A&M,67,8,Brigham Young,62,5,2008
Round of 64,East,1,North Carolina,113,16,"Mt. St. Mary's, Maryland",74,39,2008
Round of 64,East,2,Tennessee,72,15,American,57,15,2008
Round of 64,East,3,Louisville,79,14,Boise State,61,18,2008
Round of 64,East,6,Oklahoma,72,11,"St. Joseph's, Pennsylvania",64,8,2008
Round of 64,East,7,Butler,81,10,South Alabama,61,20,2008
Round of 64,East,9,Arkansas,86,8,Indiana,72,14,2008
Round of 64,Midwest,2,Georgetown,66,15,UMBC,47,19,2008
Round of 64,Midwest,10,Davidson,82,7,Gonzaga,76,6,2008
Round of 64,Midwest,12,Villanova,75,5,Clemson,69,6,2008
Round of 64,Midwest,13,Siena,83,4,Vanderbilt,62,21,2008
Round of 64,South,1,Memphis,87,16,Texas-Arlington,63,24,2008
Round of 64,South,2,Texas,74,15,Austin Peay,54,20,2008
Round of 64,South,7,"Miami, Florida",78,10,"St. Mary's, California",64,14,2008
Round of 64,South,8,Mississippi State,76,9,Oregon,69,7,2008
Round of 64,West,12,Western Kentucky,101,5,Drake,99,2,2008
Round of 64,West,13,San Diego,70,4,Connecticut,69,1,2008
Round of 32,East,4,Washington State,61,5,Notre Dame,41,20,2008
Round of 32,Midwest,1,Kansas,75,8,Nevada-Las Vegas,56,19,2008
Round of 32,Midwest,3,Wisconsin,72,11,Kansas State,55,17,2008
Round of 32,South,3,Stanford,82,6,Marquette,81,1,2008
Round of 32,South,5,Michigan State,65,4,Pittsburgh,54,11,2008
Round of 32,West,1,UCLA,53,9,Texas A&M,49,4,2008
Round of 32,West,3,"Xavier, Ohio",85,6,Purdue,78,7,2008
Round of 32,West,7,West Virginia,73,2,Duke,67,6,2008
Round of 32,East,1,North Carolina,108,9,Arkansas,77,31,2008
Round of 32,East,2,Tennessee,76,7,Butler,71,5,2008
Round of 32,East,3,Louisville,78,6,Oklahoma,48,30,2008
Round of 32,Midwest,10,Davidson,74,2,Georgetown,70,4,2008
Round of 32,Midwest,12,Villanova,84,13,Siena,72,12,2008
Round of 32,South,1,Memphis,77,8,Mississippi State,74,3,2008
Round of 32,South,2,Texas,75,7,"Miami, Florida",72,3,2008
Round of 32,West,12,Western Kentucky,72,13,San Diego,63,9,2008
Sweet Sixteen,East,1,North Carolina,68,4,Washington State,47,21,2008
Sweet Sixteen,East,3,Louisville,79,2,Tennessee,60,19,2008
Sweet Sixteen,West,1,UCLA,88,12,Western Kentucky,78,10,2008
Sweet Sixteen,West,3,"Xavier, Ohio",79,7,West Virginia,75,4,2008
Sweet Sixteen,Midwest,1,Kansas,72,12,Villanova,57,15,2008
Sweet Sixteen,Midwest,10,Davidson,73,3,Wisconsin,56,17,2008
Sweet Sixteen,South,1,Memphis,92,5,Michigan State,74,18,2008
Sweet Sixteen,South,2,Texas,82,3,Stanford,62,20,2008
Elite Eight,East,1,North Carolina,83,3,Louisville,73,10,2008
Elite Eight,West,1,UCLA,76,3,"Xavier, Ohio",57,19,2008
Elite Eight,Midwest,1,Kansas,59,10,Davidson,57,2,2008
Elite Eight,South,1,Memphis,85,2,Texas,67,18,2008
National Semifinals,National Semifinals,1,Kansas,84,1,North Carolina,66,18,2008
National Semifinals,National Semifinals,1,Memphis,78,1,UCLA,63,15,2008
National Championship,National Championship,1,Kansas,75,1,Memphis,68,7,2008
Opening Round,Midwest,16,Morehead State,58,16,Alabama State,43,15,2009
Round of 64,East,2,Duke,86,15,Binghamton,62,24,2009
Round of 64,East,3,Villanova,80,14,American,67,13,2009
Round of 64,East,6,UCLA,65,11,Virginia Commonwealth,64,1,2009
Round of 64,East,7,Texas,76,10,Minnesota,62,14,2009
Round of 64,South,1,North Carolina,101,16,Radford,58,43,2009
Round of 64,South,2,Oklahoma,82,15,Morgan State,54,28,2009
Round of 64,South,4,Gonzaga,77,13,Akron,64,13,2009
Round of 64,South,8,Louisiana State,75,9,Butler,71,4,2009
Round of 64,South,10,Michigan,62,7,Clemson,59,3,2009
Round of 64,South,12,Western Kentucky,76,5,Illinois,72,4,2009
Round of 64,West,1,Connecticut,103,16,Chattanooga,47,56,2009
Round of 64,West,2,Memphis,81,15,California State-Northridge,70,11,2009
Round of 64,West,4,Washington,71,13,Mississippi State,58,13,2009
Round of 64,West,5,Purdue,61,12,Northern Iowa,56,5,2009
Round of 64,West,9,Texas A&M,79,8,Brigham Young,66,13,2009
Round of 64,West,10,Maryland,84,7,California,71,13,2009
Round of 64,East,1,Pittsburgh,72,16,East Tennessee State,62,10,2009
Round of 64,East,4,"Xavier, Ohio",77,13,Portland State,59,18,2009
Round of 64,East,8,Oklahoma State,77,9,Tennessee,75,2,2009
Round of 64,East,12,Wisconsin,61,5,Florida State,59,2,2009
Round of 64,Midwest,1,Louisville,74,16,Morehead State,54,20,2009
Round of 64,Midwest,2,Michigan State,77,15,Robert Morris,62,15,2009
Round of 64,Midwest,3,Kansas,84,14,North Dakota State,74,10,2009
Round of 64,Midwest,9,Siena,74,8,Ohio State,72,2,2009
Round of 64,Midwest,10,Southern California,72,7,Boston College,55,17,2009
Round of 64,Midwest,11,Dayton,68,6,West Virginia,60,8,2009
Round of 64,Midwest,12,Arizona,84,5,Utah,71,13,2009
Round of 64,Midwest,13,Cleveland State,84,4,Wake Forest,69,15,2009
Round of 64,South,3,Syracuse,59,14,Stephen F. Austin,44,15,2009
Round of 64,South,6,Arizona State,66,11,Temple,57,9,2009
Round of 64,West,3,Missouri,78,14,Cornell,59,19,2009
Round of 64,West,6,Marquette,58,11,Utah State,57,1,2009
Round of 32,East,2,Duke,74,7,Texas,69,5,2009
Round of 32,East,3,Villanova,89,6,UCLA,69,20,2009
Round of 32,South,1,North Carolina,84,8,Louisiana State,70,14,2009
Round of 32,South,2,Oklahoma,73,10,Michigan,63,10,2009
Round of 32,South,4,Gonzaga,83,12,Western Kentucky,81,2,2009
Round of 32,West,1,Connecticut,92,9,Texas A&M,66,26,2009
Round of 32,West,2,Memphis,89,10,Maryland,70,19,2009
Round of 32,West,5,Purdue,76,4,Washington,74,2,2009
Round of 32,East,1,Pittsburgh,84,8,Oklahoma State,76,8,2009
Round of 32,East,4,"Xavier, Ohio",60,12,Wisconsin,49,11,2009
Round of 32,Midwest,1,Louisville,79,9,Siena,72,7,2009
Round of 32,Midwest,2,Michigan State,74,10,Southern California,69,5,2009
Round of 32,Midwest,3,Kansas,60,11,Dayton,43,17,2009
Round of 32,Midwest,12,Arizona,71,13,Cleveland State,57,14,2009
Round of 32,South,3,Syracuse,78,6,Arizona State,67,11,2009
Round of 32,West,3,Missouri,83,6,Marquette,79,4,2009
Sweet Sixteen,East,1,Pittsburgh,60,4,"Xavier, Ohio",55,5,2009
Sweet Sixteen,East,3,Villanova,77,2,Duke,54,23,2009
Sweet Sixteen,West,1,Connecticut,72,5,Purdue,60,12,2009
Sweet Sixteen,West,3,Missouri,102,2,Memphis,91,11,2009
Sweet Sixteen,Midwest,1,Louisville,103,12,Arizona,64,39,2009
Sweet Sixteen,Midwest,2,Michigan State,67,3,Kansas,62,5,2009
Sweet Sixteen,South,1,North Carolina,98,4,Gonzaga,77,21,2009
Sweet Sixteen,South,2,Oklahoma,84,3,Syracuse,71,13,2009
Elite Eight,East,3,Villanova,78,1,Pittsburgh,76,2,2009
Elite Eight,West,1,Connecticut,82,3,Missouri,75,7,2009
Elite Eight,Midwest,2,Michigan State,64,1,Louisville,52,12,2009
Elite Eight,South,1,North Carolina,72,2,Oklahoma,60,12,2009
National Semifinals,National Semifinals,1,North Carolina,83,3,Villanova,69,14,2009
National Semifinals,National Semifinals,2,Michigan State,82,1,Connecticut,73,9,2009
National Championship,National Championship,1,North Carolina,89,2,Michigan State,72,17,2009
Opening Round,South,16,Arkansas-Pine Bluff,61,16,Winthrop,44,17,2010
Round of 64,East,1,Kentucky,100,16,East Tennessee State,71,29,2010
Round of 64,East,3,New Mexico,62,14,Montana,57,5,2010
Round of 64,East,9,Wake Forest,81,8,Texas,80,1,2010
Round of 64,East,11,Washington,80,6,Marquette,78,2,2010
Round of 64,Midwest,1,Kansas,90,16,Lehigh,74,16,2010
Round of 64,Midwest,6,Tennessee,62,11,San Diego State,59,3,2010
Round of 64,Midwest,9,Northern Iowa,69,8,Nevada-Las Vegas,66,3,2010
Round of 64,Midwest,14,Ohio,97,3,Georgetown,83,14,2010
Round of 64,South,2,Villanova,73,15,Robert Morris,70,3,2010
Round of 64,South,3,Baylor,68,14,Sam Houston State,59,9,2010
Round of 64,South,10,"St. Mary's, California",80,7,Richmond,71,9,2010
Round of 64,South,11,Old Dominion,51,6,Notre Dame,50,1,2010
Round of 64,West,2,Kansas State,82,15,North Texas,62,20,2010
Round of 64,West,5,Butler,77,12,Texas-El Paso,59,18,2010
Round of 64,West,7,Brigham Young,99,10,Florida,92,7,2010
Round of 64,West,13,Murray State,66,4,Vanderbilt,65,1,2010
Round of 64,East,2,West Virginia,77,15,Morgan State,50,27,2010
Round of 64,East,4,Wisconsin,53,13,Wofford,49,4,2010
Round of 64,East,10,Missouri,86,7,Clemson,78,8,2010
Round of 64,East,12,Cornell,78,5,Temple,65,13,2010
Round of 64,Midwest,2,Ohio State,68,15,California-Santa Barbara,51,17,2010
Round of 64,Midwest,4,Maryland,89,13,Houston,77,12,2010
Round of 64,Midwest,5,Michigan State,70,12,New Mexico State,67,3,2010
Round of 64,Midwest,10,Georgia Tech,64,7,Oklahoma State,59,5,2010
Round of 64,South,1,Duke,73,16,Arkansas-Pine Bluff,44,29,2010
Round of 64,South,4,Purdue,72,13,Siena,64,8,2010
Round of 64,South,5,Texas A&M,69,12,Utah State,53,16,2010
Round of 64,South,8,California,77,9,Louisville,62,15,2010
Round of 64,West,1,Syracuse,79,16,Vermont,56,23,2010
Round of 64,West,3,Pittsburgh,89,14,Oakland,66,23,2010
Round of 64,West,6,"Xavier, Ohio",65,11,Minnesota,54,11,2010
Round of 64,West,8,Gonzaga,67,9,Florida State,60,7,2010
Round of 32,East,1,Kentucky,90,9,Wake Forest,60,30,2010
Round of 32,East,11,Washington,82,3,New Mexico,64,18,2010
Round of 32,Midwest,6,Tennessee,83,14,Ohio,68,15,2010
Round of 32,Midwest,9,Northern Iowa,69,1,Kansas,67,2,2010
Round of 32,South,3,Baylor,76,11,Old Dominion,68,8,2010
Round of 32,South,10,"St. Mary's, California",75,2,Villanova,68,7,2010
Round of 32,West,2,Kansas State,84,7,Brigham Young,72,12,2010
Round of 32,West,5,Butler,54,13,Murray State,52,2,2010
Round of 32,East,2,West Virginia,68,10,Missouri,59,9,2010
Round of 32,East,12,Cornell,87,4,Wisconsin,69,18,2010
Round of 32,Midwest,2,Ohio State,75,10,Georgia Tech,66,9,2010
Round of 32,Midwest,5,Michigan State,85,4,Maryland,83,2,2010
Round of 32,South,1,Duke,68,8,California,53,15,2010
Round of 32,South,4,Purdue,63,5,Texas A&M,61,2,2010
Round of 32,West,1,Syracuse,87,8,Gonzaga,65,22,2010
Round of 32,West,6,"Xavier, Ohio",71,3,Pittsburgh,68,3,2010
Sweet Sixteen,East,1,Kentucky,62,12,Cornell,45,17,2010
Sweet Sixteen,East,2,West Virginia,69,11,Washington,56,13,2010
Sweet Sixteen,West,2,Kansas State,101,6,"Xavier, Ohio",96,5,2010
Sweet Sixteen,West,5,Butler,63,1,Syracuse,59,4,2010
Sweet Sixteen,Midwest,5,Michigan State,59,9,Northern Iowa,52,7,2010
Sweet Sixteen,Midwest,6,Tennessee,76,2,Ohio State,73,3,2010
Sweet Sixteen,South,1,Duke,70,4,Purdue,57,13,2010
Sweet Sixteen,South,3,Baylor,72,10,"St. Mary's, California",49,23,2010
Elite Eight,East,2,West Virginia,73,1,Kentucky,66,7,2010
Elite Eight,West,5,Butler,63,2,Kansas State,56,7,2010
Elite Eight,Midwest,5,Michigan State,70,6,Tennessee,69,1,2010
Elite Eight,South,1,Duke,78,3,Baylor,71,7,2010
National Semifinals,National Semifinals,1,Duke,78,2,West Virginia,57,21,2010
National Semifinals,National Semifinals,5,Butler,52,5,Michigan State,50,2,2010
National Championship,National Championship,1,Duke,61,5,Butler,59,2,2010
Opening Round,East,12,Clemson,70,12,UAB,52,18,2011
Opening Round,Southeast,16,North Carolina-Asheville,81,16,Arkansas-Little Rock,77,4,2011
Opening Round,East,16,Texas-San Antonio,70,16,Alabama State,61,9,2011
Opening Round,Southwest,11,Virginia Commonwealth,59,11,Southern California,46,13,2011
Round of 64,East,4,Kentucky,59,13,Princeton,57,2,2011
Round of 64,East,5,West Virginia,84,12,Clemson,76,8,2011
Round of 64,Southeast,1,Pittsburgh,74,16,North Carolina-Asheville,51,23,2011
Round of 64,Southeast,2,Florida,79,15,California-Santa Barbara,51,28,2011
Round of 64,Southeast,3,Brigham Young,74,14,Wofford,66,8,2011
Round of 64,Southeast,4,Wisconsin,72,13,Belmont,58,14,2011
Round of 64,Southeast,5,Kansas State,73,12,Utah State,68,5,2011
Round of 64,Southeast,7,UCLA,78,10,Michigan State,76,2,2011
Round of 64,Southeast,8,Butler,60,9,Old Dominion,58,2,2011
Round of 64,Southeast,11,Gonzaga,86,6,"St. John's, New York",71,15,2011
Round of 64,Southwest,12,Richmond,69,5,Vanderbilt,66,3,2011
Round of 64,Southwest,13,Morehead State,62,4,Louisville,61,1,2011
Round of 64,West,2,San Diego State,68,15,Northern Colorado,50,18,2011
Round of 64,West,3,Connecticut,81,14,Bucknell,52,29,2011
Round of 64,West,6,Cincinnati,78,11,Missouri,63,15,2011
Round of 64,West,7,Temple,66,10,Pennsylvania State,64,2,2011
Round of 64,East,1,Ohio State,75,16,Texas-San Antonio,46,29,2011
Round of 64,East,2,North Carolina,102,15,Long Island-Brooklyn,87,15,2011
Round of 64,East,3,Syracuse,77,14,Indiana State,60,17,2011
Round of 64,East,7,Washington,68,10,Georgia,65,3,2011
Round of 64,East,8,George Mason,61,9,Villanova,57,4,2011
Round of 64,East,11,Marquette,66,6,"Xavier, Ohio",55,11,2011
Round of 64,Southwest,1,Kansas,72,16,Boston,53,19,2011
Round of 64,Southwest,2,Notre Dame,69,15,Akron,56,13,2011
Round of 64,Southwest,3,Purdue,65,14,St. Peter's,43,22,2011
Round of 64,Southwest,9,Illinois,73,8,Nevada-Las Vegas,62,11,2011
Round of 64,Southwest,10,Florida State,57,7,Texas A&M,50,7,2011
Round of 64,Southwest,11,Virginia Commonwealth,74,6,Georgetown,56,18,2011
Round of 64,West,1,Duke,87,16,Hampton,45,42,2011
Round of 64,West,4,Texas,85,13,Oakland,81,4,2011
Round of 64,West,5,Arizona,77,12,Memphis,75,2,2011
Round of 64,West,8,Michigan,75,9,Tennessee,45,30,2011
Round of 32,East,4,Kentucky,71,5,West Virginia,63,8,2011
Round of 32,Southeast,2,Florida,73,7,UCLA,65,8,2011
Round of 32,Southeast,3,Brigham Young,89,11,Gonzaga,67,22,2011
Round of 32,Southeast,4,Wisconsin,70,5,Kansas State,65,5,2011
Round of 32,Southeast,8,Butler,71,1,Pittsburgh,70,1,2011
Round of 32,Southwest,12,Richmond,65,13,Morehead State,48,17,2011
Round of 32,West,2,San Diego State,71,7,Temple,64,7,2011
Round of 32,West,3,Connecticut,69,6,Cincinnati,58,11,2011
Round of 32,East,1,Ohio State,98,8,George Mason,66,32,2011
Round of 32,East,2,North Carolina,86,7,Washington,83,3,2011
Round of 32,East,11,Marquette,66,3,Syracuse,62,4,2011
Round of 32,Southwest,1,Kansas,73,9,Illinois,59,14,2011
Round of 32,Southwest,10,Florida State,71,2,Notre Dame,57,14,2011
Round of 32,Southwest,11,Virginia Commonwealth,94,3,Purdue,76,18,2011
Round of 32,West,1,Duke,73,8,Michigan,71,2,2011
Round of 32,West,5,Arizona,70,4,Texas,69,1,2011
Sweet Sixteen,Southeast,2,Florida,83,3,Brigham Young,74,9,2011
Sweet Sixteen,Southeast,8,Butler,61,4,Wisconsin,54,7,2011
Sweet Sixteen,West,3,Connecticut,74,2,San Diego State,67,7,2011
Sweet Sixteen,West,5,Arizona,93,1,Duke,77,16,2011
Sweet Sixteen,East,2,North Carolina,81,11,Marquette,63,18,2011
Sweet Sixteen,East,4,Kentucky,62,1,Ohio State,60,2,2011
Sweet Sixteen,Southwest,1,Kansas,77,12,Richmond,57,20,2011
Sweet Sixteen,Southwest,11,Virginia Commonwealth,72,10,Florida State,71,1,2011
Elite Eight,Southeast,8,Butler,74,2,Florida,71,3,2011
Elite Eight,West,3,Connecticut,65,5,Arizona,63,2,2011
Elite Eight,East,4,Kentucky,76,2,North Carolina,69,7,2011
Elite Eight,Southwest,11,Virginia Commonwealth,71,1,Kansas,61,10,2011
National Semifinals,National Semifinals,3,Connecticut,56,4,Kentucky,55,1,2011
National Semifinals,National Semifinals,8,Butler,70,11,Virginia Commonwealth,62,8,2011
National Championship,National Championship,3,Connecticut,53,8,Butler,41,12,2011
Opening Round,South,16,Western Kentucky,59,16,Mississippi Valley,58,1,2012
Opening Round,West,14,Brigham Young,78,14,Iona,72,6,2012
Opening Round,Midwest,12,South Florida,65,12,California,54,11,2012
Opening Round,Midwest,16,Vermont,71,16,Lamar,59,12,2012
Round of 64,East,1,Syracuse,72,16,North Carolina-Asheville,65,7,2012
Round of 64,East,2,Ohio State,78,15,"Loyola, Maryland",59,19,2012
Round of 64,East,4,Wisconsin,73,13,Montana,49,24,2012
Round of 64,East,5,Vanderbilt,79,12,Harvard,70,9,2012
Round of 64,East,7,Gonzaga,77,10,West Virginia,54,23,2012
Round of 64,East,8,Kansas State,70,9,Southern Mississippi,64,6,2012
Round of 64,South,1,Kentucky,81,16,Western Kentucky,66,15,2012
Round of 64,South,3,Baylor,68,14,South Dakota State,60,8,2012
Round of 64,South,4,Indiana,79,13,New Mexico State,66,13,2012
Round of 64,South,8,Iowa State,77,9,Connecticut,64,13,2012
Round of 64,South,11,Colorado,68,6,Nevada-Las Vegas,64,4,2012
Round of 64,South,12,Virginia Commonwealth,62,5,Wichita State,59,3,2012
Round of 64,West,3,Marquette,88,14,Brigham Young,68,20,2012
Round of 64,West,4,Louisville,69,13,Davidson,62,7,2012
Round of 64,West,5,New Mexico,75,12,Long Beach State,68,7,2012
Round of 64,West,6,Murray State,58,11,Colorado State,41,17,2012
Round of 64,East,3,Florida State,66,14,St. Bonaventure,63,3,2012
Round of 64,East,6,Cincinnati,65,11,Texas,59,6,2012
Round of 64,Midwest,1,North Carolina,77,16,Vermont,58,19,2012
Round of 64,Midwest,2,Kansas,65,15,Detroit,50,15,2012
Round of 64,Midwest,3,Georgetown,74,14,Belmont,59,15,2012
Round of 64,Midwest,8,Creighton,58,9,Alabama,57,1,2012
Round of 64,Midwest,10,Purdue,72,7,"St. Mary's, California",69,3,2012
Round of 64,Midwest,11,North Carolina State,79,6,San Diego State,65,14,2012
Round of 64,Midwest,12,South Florida,58,5,Temple,44,14,2012
Round of 64,Midwest,13,Ohio,65,4,Michigan,60,5,2012
Round of 64,South,10,"Xavier, Ohio",67,7,Notre Dame,63,4,2012
Round of 64,South,15,Lehigh,75,2,Duke,70,5,2012
Round of 64,West,1,Michigan State,89,16,Long Island-Brooklyn,67,22,2012
Round of 64,West,7,Florida,71,10,Virginia,45,26,2012
Round of 64,West,9,St. Louis,61,8,Memphis,54,7,2012
Round of 64,West,15,Norfolk State,86,2,Missouri,84,2,2012
Round of 32,East,1,Syracuse,75,8,Kansas State,59,16,2012
Round of 32,East,2,Ohio State,73,7,Gonzaga,66,7,2012
Round of 32,East,4,Wisconsin,60,5,Vanderbilt,57,3,2012
Round of 32,South,1,Kentucky,87,8,Iowa State,71,16,2012
Round of 32,South,3,Baylor,80,11,Colorado,63,17,2012
Round of 32,South,4,Indiana,63,12,Virginia Commonwealth,61,2,2012
Round of 32,West,3,Marquette,62,6,Murray State,53,9,2012
Round of 32,West,4,Louisville,59,5,New Mexico,56,3,2012
Round of 32,East,6,Cincinnati,62,3,Florida State,56,6,2012
Round of 32,Midwest,1,North Carolina,87,8,Creighton,73,14,2012
Round of 32,Midwest,2,Kansas,63,10,Purdue,60,3,2012
Round of 32,Midwest,11,North Carolina State,66,3,Georgetown,63,3,2012
Round of 32,Midwest,13,Ohio,62,12,South Florida,56,6,2012
Round of 32,South,10,"Xavier, Ohio",70,15,Lehigh,58,12,2012
Round of 32,West,1,Michigan State,65,9,St. Louis,61,4,2012
Round of 32,West,7,Florida,84,15,Norfolk State,50,34,2012
Sweet Sixteen,East,1,Syracuse,64,4,Wisconsin,63,1,2012
Sweet Sixteen,East,2,Ohio State,81,6,Cincinnati,66,15,2012
Sweet Sixteen,West,4,Louisville,57,1,Michigan State,44,13,2012
Sweet Sixteen,West,7,Florida,68,3,Marquette,58,10,2012
Sweet Sixteen,Midwest,1,North Carolina,73,13,Ohio,65,8,2012
Sweet Sixteen,Midwest,2,Kansas,60,11,North Carolina State,57,3,2012
Sweet Sixteen,South,1,Kentucky,102,4,Indiana,90,12,2012
Sweet Sixteen,South,3,Baylor,75,10,"Xavier, Ohio",70,5,2012
Elite Eight,East,2,Ohio State,77,1,Syracuse,70,7,2012
Elite Eight,West,4,Louisville,72,7,Florida,68,4,2012
Elite Eight,Midwest,2,Kansas,80,1,North Carolina,67,13,2012
Elite Eight,South,1,Kentucky,82,3,Baylor,70,12,2012
National Semifinals,National Semifinals,1,Kentucky,69,4,Louisville,61,8,2012
National Semifinals,National Semifinals,2,Kansas,64,2,Ohio State,62,2,2012
National Championship,National Championship,1,Kentucky,67,2,Kansas,59,8,2012
Opening Round,Midwest,11,"St. Mary's, California",67,11,Middle Tennessee State,54,13,2013
Opening Round,Midwest,16,North Carolina A&T,73,16,Liberty,72,1,2013
Opening Round,East,16,James Madison,68,16,Long Island-Brooklyn,55,13,2013
Opening Round,West,13,La Salle,80,13,Boise State,71,9,2013
Round of 64,East,3,Marquette,59,14,Davidson,58,1,2013
Round of 64,East,4,Syracuse,81,13,Montana,34,47,2013
Round of 64,East,6,Butler,68,11,Bucknell,56,12,2013
Round of 64,East,12,California,64,5,Nevada-Las Vegas,61,3,2013
Round of 64,Midwest,1,Louisville,79,16,North Carolina A&T,48,31,2013
Round of 64,Midwest,3,Michigan State,65,14,Valparaiso,54,11,2013
Round of 64,Midwest,4,St. Louis,64,13,New Mexico State,44,20,2013
Round of 64,Midwest,6,Memphis,54,11,"St. Mary's, California",52,2,2013
Round of 64,Midwest,8,Colorado State,84,9,Missouri,72,12,2013
Round of 64,Midwest,12,Oregon,68,5,Oklahoma State,55,13,2013
Round of 64,South,4,Michigan,71,13,South Dakota State,56,15,2013
Round of 64,South,5,Virginia Commonwealth,88,12,Akron,42,46,2013
Round of 64,West,1,Gonzaga,64,16,Southern,58,6,2013
Round of 64,West,6,Arizona,81,11,Belmont,64,17,2013
Round of 64,West,9,Wichita State,73,8,Pittsburgh,55,18,2013
Round of 64,West,14,Harvard,68,3,New Mexico,62,6,2013
Round of 64,East,1,Indiana,83,16,James Madison,62,21,2013
Round of 64,East,2,"Miami, Florida",78,15,"Pacific, California",49,29,2013
Round of 64,East,7,Illinois,57,10,Colorado,49,8,2013
Round of 64,East,9,Temple,76,8,North Carolina State,72,4,2013
Round of 64,Midwest,2,Duke,73,15,Albany,61,12,2013
Round of 64,Midwest,7,Creighton,67,10,Cincinnati,63,4,2013
Round of 64,South,1,Kansas,64,16,Western Kentucky,57,7,2013
Round of 64,South,3,Florida,79,14,Northwestern State,47,32,2013
Round of 64,South,7,San Diego State,70,10,Oklahoma,55,15,2013
Round of 64,South,8,North Carolina,78,9,Villanova,71,7,2013
Round of 64,South,11,Minnesota,83,6,UCLA,63,20,2013
Round of 64,South,15,Florida Gulf Coast,78,2,Georgetown,68,10,2013
Round of 64,West,2,Ohio State,95,15,Iona,70,25,2013
Round of 64,West,10,Iowa State,76,7,Notre Dame,58,18,2013
Round of 64,West,12,Mississippi,57,5,Wisconsin,46,11,2013
Round of 64,West,13,La Salle,63,4,Kansas State,61,2,2013
Round of 32,East,3,Marquette,74,6,Butler,72,2,2013
Round of 32,East,4,Syracuse,66,12,California,60,6,2013
Round of 32,Midwest,1,Louisville,82,8,Colorado State,56,26,2013
Round of 32,Midwest,3,Michigan State,70,6,Memphis,48,22,2013
Round of 32,Midwest,12,Oregon,74,4,St. Louis,57,17,2013
Round of 32,South,4,Michigan,78,5,Virginia Commonwealth,53,25,2013
Round of 32,West,6,Arizona,74,14,Harvard,51,23,2013
Round of 32,West,9,Wichita State,76,1,Gonzaga,70,6,2013
Round of 32,East,1,Indiana,58,9,Temple,52,6,2013
Round of 32,East,2,"Miami, Florida",63,7,Illinois,59,4,2013
Round of 32,Midwest,2,Duke,66,7,Creighton,50,16,2013
Round of 32,South,1,Kansas,70,8,North Carolina,58,12,2013
Round of 32,South,3,Florida,78,11,Minnesota,64,14,2013
Round of 32,South,15,Florida Gulf Coast,81,7,San Diego State,71,10,2013
Round of 32,West,2,Ohio State,78,10,Iowa State,75,3,2013
Round of 32,West,13,La Salle,76,12,Mississippi,74,2,2013
Sweet Sixteen,East,3,Marquette,71,2,"Miami, Florida",61,10,2013
Sweet Sixteen,East,4,Syracuse,61,1,Indiana,50,11,2013
Sweet Sixteen,West,2,Ohio State,73,6,Arizona,70,3,2013
Sweet Sixteen,West,9,Wichita State,72,13,La Salle,58,14,2013
Sweet Sixteen,Midwest,1,Louisville,77,12,Oregon,69,8,2013
Sweet Sixteen,Midwest,2,Duke,71,3,Michigan State,61,10,2013
Sweet Sixteen,South,3,Florida,62,15,Florida Gulf Coast,50,12,2013
Sweet Sixteen,South,4,Michigan,87,1,Kansas,85,2,2013
Elite Eight,East,4,Syracuse,55,3,Marquette,39,16,2013
Elite Eight,West,9,Wichita State,70,2,Ohio State,66,4,2013
Elite Eight,Midwest,1,Louisville,85,2,Duke,63,22,2013
Elite Eight,South,4,Michigan,79,3,Florida,59,20,2013
National Semifinals,NA,1,Louisville,72,9,Wichita State,68,4,2013
National Semifinals,NA,4,Michigan,61,4,Syracuse,56,5,2013
National Championship,NA,1,Louisville,82,4,Michigan,76,6,2013
Opening Round,Midwest,12,North Carolina State,74,12,"Xavier, Ohio",59,15,2014
Opening Round,South,16,Albany,71,16,"Mt. St. Mary's, Maryland",64,7,2014
Opening Round,Midwest,11,Tennessee,78,11,Iowa,65,13,2014
Opening Round,Midwest,16,Cal Poly,81,16,Texas Southern,69,12,2014
Round of 64,East,2,Villanova,73,15,Milwaukee,53,20,2014
Round of 64,East,4,Michigan State,93,13,Delaware,78,15,2014
Round of 64,East,7,Connecticut,89,10,"St. Joseph's, Pennsylvania",81,8,2014
Round of 64,East,12,Harvard,61,5,Cincinnati,57,4,2014
Round of 64,Midwest,2,Michigan,57,15,Wofford,40,17,2014
Round of 64,Midwest,4,Louisville,71,13,Manhattan,64,7,2014
Round of 64,Midwest,5,St. Louis,83,12,North Carolina State,80,3,2014
Round of 64,Midwest,7,Texas,87,10,Arizona State,85,2,2014
Round of 64,South,1,Florida,67,16,Albany,55,12,2014
Round of 64,South,3,Syracuse,77,14,Western Michigan,53,24,2014
Round of 64,South,9,Pittsburgh,77,8,Colorado,48,29,2014
Round of 64,South,11,Dayton,60,6,Ohio State,59,1,2014
Round of 64,West,2,Wisconsin,75,15,American,35,40,2014
Round of 64,West,4,San Diego State,73,13,New Mexico State,69,4,2014
Round of 64,West,7,Oregon,87,10,Brigham Young,68,19,2014
Round of 64,West,12,North Dakota State,80,5,Oklahoma,75,5,2014
Round of 64,East,1,Virginia,70,16,Coastal Carolina,59,11,2014
Round of 64,East,3,Iowa State,93,14,North Carolina Central,75,18,2014
Round of 64,East,6,North Carolina,79,11,Providence,77,2,2014
Round of 64,East,8,Memphis,71,9,George Washington,66,5,2014
Round of 64,Midwest,1,Wichita State,64,16,Cal Poly,37,27,2014
Round of 64,Midwest,8,Kentucky,56,9,Kansas State,49,7,2014
Round of 64,Midwest,11,Tennessee,86,6,Massachusetts,67,19,2014
Round of 64,Midwest,14,Mercer,78,3,Duke,71,7,2014
Round of 64,South,2,Kansas,80,15,Eastern Kentucky,69,11,2014
Round of 64,South,4,UCLA,76,13,Tulsa,59,17,2014
Round of 64,South,10,Stanford,58,7,New Mexico,53,5,2014
Round of 64,South,12,Stephen F. Austin,77,5,Virginia Commonwealth,75,2,2014
Round of 64,West,1,Arizona,68,16,Weber State,59,9,2014
Round of 64,West,3,Creighton,76,14,Louisiana-Lafayette,66,10,2014
Round of 64,West,6,Baylor,74,11,Nebraska,60,14,2014
Round of 64,West,8,Gonzaga,85,9,Oklahoma State,77,8,2014
Round of 32,East,4,Michigan State,80,12,Harvard,73,7,2014
Round of 32,East,7,Connecticut,77,2,Villanova,65,12,2014
Round of 32,Midwest,2,Michigan,79,7,Texas,65,14,2014
Round of 32,Midwest,4,Louisville,66,5,St. Louis,51,15,2014
Round of 32,South,1,Florida,61,9,Pittsburgh,45,16,2014
Round of 32,South,11,Dayton,55,3,Syracuse,53,2,2014
Round of 32,West,2,Wisconsin,85,7,Oregon,77,8,2014
Round of 32,West,4,San Diego State,63,12,North Dakota State,44,19,2014
Round of 32,East,1,Virginia,78,8,Memphis,60,18,2014
Round of 32,East,3,Iowa State,85,6,North Carolina,83,2,2014
Round of 32,Midwest,8,Kentucky,78,1,Wichita State,76,2,2014
Round of 32,Midwest,11,Tennessee,83,14,Mercer,63,20,2014
Round of 32,South,4,UCLA,77,12,Stephen F. Austin,60,17,2014
Round of 32,South,10,Stanford,60,2,Kansas,57,3,2014
Round of 32,West,1,Arizona,84,8,Gonzaga,61,23,2014
Round of 32,West,6,Baylor,85,3,Creighton,55,30,2014
Sweet Sixteen,South,1,Florida,79,4,UCLA,68,11,2014
Sweet Sixteen,South,11,Dayton,82,10,Stanford,72,10,2014
Sweet Sixteen,West,1,Arizona,70,4,San Diego State,64,6,2014
Sweet Sixteen,West,2,Wisconsin,69,6,Baylor,52,17,2014
Sweet Sixteen,East,4,Michigan State,61,1,Virginia,59,2,2014
Sweet Sixteen,East,7,Connecticut,81,3,Iowa State,76,5,2014
Sweet Sixteen,Midwest,2,Michigan,73,11,Tennessee,71,2,2014
Sweet Sixteen,Midwest,8,Kentucky,74,4,Louisville,69,5,2014
Elite Eight,South,1,Florida,62,11,Dayton,52,10,2014
Elite Eight,West,2,Wisconsin,64,1,Arizona,63,1,2014
Elite Eight,East,7,Connecticut,60,4,Michigan State,54,6,2014
Elite Eight,Midwest,8,Kentucky,75,2,Michigan,72,3,2014
National Semifinals,NA,7,Connecticut,63,1,Florida,53,10,2014
National Semifinals,NA,8,Kentucky,74,2,Wisconsin,73,1,2014
National Championship,NA,7,Connecticut,60,8,Kentucky,54,6,2014
Opening Round,Midwest,16,Hampton,74,16,Manhattan,64,10,2015
Opening Round,West,11,Mississippi,94,11,Brigham Young,90,4,2015
Opening Round,East,11,Dayton,56,11,Boise State,55,1,2015
Opening Round,South,16,Robert Morris,81,16,North Florida,77,4,2015
Round of 64,East,1,Villanova,93,16,Lafayette,52,41,2015
Round of 64,East,8,North Carolina State,66,9,Louisiana State,65,1,2015
Round of 64,Midwest,1,Kentucky,79,16,Hampton,56,23,2015
Round of 64,Midwest,3,Notre Dame,69,14,Northeastern,65,4,2015
Round of 64,Midwest,6,Butler,56,11,Texas,48,8,2015
Round of 64,Midwest,8,Cincinnati,66,9,Purdue,65,1,2015
Round of 64,South,4,Georgetown,84,13,Eastern Washington,74,10,2015
Round of 64,South,5,Utah,57,12,Stephen F. Austin,50,7,2015
Round of 64,South,11,UCLA,60,6,Southern Methodist,59,1,2015
Round of 64,South,14,UAB,60,3,Iowa State,59,1,2015
Round of 64,West,2,Arizona,93,15,Texas Southern,72,21,2015
Round of 64,West,4,North Carolina,67,13,Harvard,65,2,2015
Round of 64,West,5,Arkansas,56,12,Wofford,53,3,2015
Round of 64,West,6,"Xavier, Ohio",76,11,Mississippi,57,19,2015
Round of 64,West,10,Ohio State,75,7,Virginia Commonwealth,72,3,2015
Round of 64,West,14,Georgia State,57,3,Baylor,56,1,2015
Round of 64,East,2,Virginia,79,15,Belmont,67,12,2015
Round of 64,East,3,Oklahoma,69,14,Albany,60,9,2015
Round of 64,East,4,Louisville,57,13,California-Irvine,55,2,2015
Round of 64,East,5,Northern Iowa,71,12,Wyoming,54,17,2015
Round of 64,East,7,Michigan State,70,10,Georgia,63,7,2015
Round of 64,East,11,Dayton,66,6,Providence,53,13,2015
Round of 64,Midwest,2,Kansas,75,15,New Mexico State,56,19,2015
Round of 64,Midwest,4,Maryland,65,13,Valparaiso,62,3,2015
Round of 64,Midwest,5,West Virginia,68,12,Buffalo,62,6,2015
Round of 64,Midwest,7,Wichita State,81,10,Indiana,76,5,2015
Round of 64,South,1,Duke,85,16,Robert Morris,56,29,2015
Round of 64,South,2,Gonzaga,86,15,North Dakota State,76,10,2015
Round of 64,South,7,Iowa,83,10,Davidson,52,31,2015
Round of 64,South,8,San Diego State,76,9,"St. John's, New York",64,12,2015
Round of 64,West,1,Wisconsin,86,16,Coastal Carolina,72,14,2015
Round of 64,West,8,Oregon,79,9,Oklahoma State,73,6,2015
Round of 32,East,8,North Carolina State,71,1,Villanova,68,3,2015
Round of 32,Midwest,1,Kentucky,64,8,Cincinnati,51,13,2015
Round of 32,Midwest,3,Notre Dame,67,6,Butler,64,3,2015
Round of 32,South,5,Utah,75,4,Georgetown,64,11,2015
Round of 32,South,11,UCLA,92,14,UAB,75,17,2015
Round of 32,West,2,Arizona,73,10,Ohio State,58,15,2015
Round of 32,West,4,North Carolina,87,5,Arkansas,78,9,2015
Round of 32,West,6,"Xavier, Ohio",75,14,Georgia State,67,8,2015
Round of 32,East,3,Oklahoma,72,11,Dayton,66,6,2015
Round of 32,East,4,Louisville,66,5,Northern Iowa,53,13,2015
Round of 32,East,7,Michigan State,60,2,Virginia,54,6,2015
Round of 32,Midwest,5,West Virginia,69,4,Maryland,59,10,2015
Round of 32,Midwest,7,Wichita State,78,2,Kansas,65,13,2015
Round of 32,South,1,Duke,68,8,San Diego State,49,19,2015
Round of 32,South,2,Gonzaga,87,7,Iowa,69,18,2015
Round of 32,West,1,Wisconsin,72,8,Oregon,65,7,2015
Sweet Sixteen,Midwest,1,Kentucky,78,5,West Virginia,39,39,2015
Sweet Sixteen,Midwest,3,Notre Dame,81,7,Wichita State,70,11,2015
Sweet Sixteen,West,1,Wisconsin,79,4,North Carolina,72,7,2015
Sweet Sixteen,West,2,Arizona,68,6,"Xavier, Ohio",60,8,2015
Sweet Sixteen,East,4,Louisville,75,8,North Carolina State,65,10,2015
Sweet Sixteen,East,7,Michigan State,62,3,Oklahoma,58,4,2015
Sweet Sixteen,South,1,Duke,63,5,Utah,57,6,2015
Sweet Sixteen,South,2,Gonzaga,74,11,UCLA,62,12,2015
Elite Eight,Midwest,1,Kentucky,68,3,Notre Dame,66,2,2015
Elite Eight,West,1,Wisconsin,85,2,Arizona,78,7,2015
Elite Eight,East,7,Michigan State,76,4,Louisville,70,6,2015
Elite Eight,South,1,Duke,66,2,Gonzaga,52,14,2015
National Semifinals,NA,1,Duke,81,7,Michigan State,61,20,2015
National Semifinals,NA,1,Wisconsin,71,1,Kentucky,64,7,2015
National Championship,NA,1,Duke,68,1,Wisconsin,63,5,2015
Opening Round,East,16,Florida Gulf Coast,96,16,Fairleigh Dickinson,65,31,2016
Opening Round,South,11,Wichita State,70,11,Vanderbilt,50,20,2016
Opening Round,East,11,Michigan,67,11,Tulsa,62,5,2016
Opening Round,West,16,Holy Cross,59,16,Southern,55,4,2016
Round of 64,East,1,North Carolina,83,16,Florida Gulf Coast,67,16,2016
Round of 64,East,4,Kentucky,85,13,Stony Brook,57,28,2016
Round of 64,East,5,Indiana,99,12,Chattanooga,74,25,2016
Round of 64,East,9,Providence,70,8,Southern California,69,1,2016
Round of 64,Midwest,1,Virginia,81,16,Hampton,45,36,2016
Round of 64,Midwest,3,Utah,80,14,Fresno State,69,11,2016
Round of 64,Midwest,4,Iowa State,94,13,Iona,81,13,2016
Round of 64,Midwest,9,Butler,71,8,Texas Tech,61,10,2016
Round of 64,Midwest,11,Gonzaga,68,6,Seton Hall,52,16,2016
Round of 64,Midwest,12,Arkansas-Little Rock,85,5,Purdue,83,2,2016
Round of 64,South,1,Kansas,105,16,Austin Peay,79,26,2016
Round of 64,South,3,"Miami, Florida",79,14,Buffalo,72,7,2016
Round of 64,South,9,Connecticut,74,8,Colorado,67,7,2016
Round of 64,South,11,Wichita State,65,6,Arizona,55,10,2016
Round of 64,West,4,Duke,93,13,North Carolina-Wilmington,85,8,2016
Round of 64,West,12,Yale,79,5,Baylor,75,4,2016
Round of 64,East,2,"Xavier, Ohio",71,15,Weber State,53,18,2016
Round of 64,East,6,Notre Dame,70,11,Michigan,63,7,2016
Round of 64,East,7,Wisconsin,47,10,Pittsburgh,43,4,2016
Round of 64,East,14,Stephen F. Austin,70,3,West Virginia,56,14,2016
Round of 64,Midwest,10,Syracuse,70,7,Dayton,51,19,2016
Round of 64,Midwest,15,Middle Tennessee State,90,2,Michigan State,81,9,2016
Round of 64,South,2,Villanova,86,15,North Carolina-Asheville,56,30,2016
Round of 64,South,5,Maryland,79,12,South Dakota State,74,5,2016
Round of 64,South,7,Iowa,72,10,Temple,70,2,2016
Round of 64,South,13,Hawaii,77,4,California,66,11,2016
Round of 64,West,1,Oregon,91,16,Holy Cross,52,39,2016
Round of 64,West,2,Oklahoma,82,15,California State-Bakersfield,68,14,2016
Round of 64,West,3,Texas A&M,92,14,Green Bay,65,27,2016
Round of 64,West,8,"St. Joseph's, Pennsylvania",78,9,Cincinnati,76,2,2016
Round of 64,West,10,Virginia Commonwealth,75,7,Oregon State,67,8,2016
Round of 64,West,11,Northern Iowa,75,6,Texas,72,3,2016
Round of 32,East,1,North Carolina,85,9,Providence,66,19,2016
Round of 32,East,5,Indiana,73,4,Kentucky,67,6,2016
Round of 32,Midwest,1,Virginia,77,9,Butler,69,8,2016
Round of 32,Midwest,4,Iowa State,78,12,Arkansas-Little Rock,61,17,2016
Round of 32,Midwest,11,Gonzaga,82,3,Utah,59,23,2016
Round of 32,South,1,Kansas,73,9,Connecticut,61,12,2016
Round of 32,South,3,"Miami, Florida",65,11,Wichita State,57,8,2016
Round of 32,West,4,Duke,71,12,Yale,64,7,2016
Round of 32,East,6,Notre Dame,76,14,Stephen F. Austin,75,1,2016
Round of 32,East,7,Wisconsin,66,2,"Xavier, Ohio",63,3,2016
Round of 32,Midwest,10,Syracuse,75,15,Middle Tennessee State,50,25,2016
Round of 32,South,2,Villanova,87,7,Iowa,68,19,2016
Round of 32,South,5,Maryland,73,13,Hawaii,60,13,2016
Round of 32,West,1,Oregon,69,8,"St. Joseph's, Pennsylvania",64,5,2016
Round of 32,West,2,Oklahoma,85,10,Virginia Commonwealth,81,4,2016
Round of 32,West,3,Texas A&M,92,11,Northern Iowa,88,4,2016
Sweet Sixteen,South,1,Kansas,79,5,Maryland,63,16,2016
Sweet Sixteen,South,2,Villanova,92,3,"Miami, Florida",69,23,2016
Sweet Sixteen,West,1,Oregon,82,4,Duke,68,14,2016
Sweet Sixteen,West,2,Oklahoma,77,3,Texas A&M,63,14,2016
Sweet Sixteen,East,1,North Carolina,101,5,Indiana,86,15,2016
Sweet Sixteen,East,6,Notre Dame,61,7,Wisconsin,56,5,2016
Sweet Sixteen,Midwest,1,Virginia,84,4,Iowa State,71,13,2016
Sweet Sixteen,Midwest,10,Syracuse,63,11,Gonzaga,60,3,2016
Elite Eight,South,2,Villanova,64,1,Kansas,59,5,2016
Elite Eight,West,2,Oklahoma,80,1,Oregon,68,12,2016
Elite Eight,East,1,North Carolina,88,6,Notre Dame,74,14,2016
Elite Eight,Midwest,10,Syracuse,68,1,Virginia,62,6,2016
National Semifinals,NA,1,North Carolina,83,10,Syracuse,66,17,2016
National Semifinals,NA,2,Villanova,95,2,Oklahoma,51,44,2016
National Championship,NA,2,Villanova,77,1,North Carolina,74,3,2016
